,Precinct,Registered Voters Total,Registered Voters Male,Registered Voters Female,Voters Who Actually Voted (Total),Voters Who Actually Voted (Male),Voters Who Actually Voted (Female),Voting Percentage (Total),Voting Percentage (Male),Voting Percentage (Female),Barangay
0,0126A,198,84,114,194,82,112,97.98,97.62,98.25,BRGY BARITAN
1,0126B,193,89,104,186,83,103,96.37,93.26,99.04,BRGY BARITAN
2,0127A,195,86,109,184,79,105,94.36,91.86,96.33,BRGY BARITAN
3,0127B,181,87,94,1,0,1,0.55,0.0,1.06,BRGY BARITAN
4,0128A,191,83,108,169,72,97,88.48,86.75,89.81,BRGY BARITAN
5,0129A,194,79,115,137,56,81,70.62,70.89,70.43,BRGY BARITAN
6,0129B,193,83,110,142,64,78,73.58,77.11,70.91,BRGY BARITAN
7,0130A,186,90,96,161,77,84,86.56,85.56,87.5,BRGY BARITAN
8,0131A,192,64,128,149,47,102,77.6,73.44,79.69,BRGY BARITAN
9,0132A,197,100,97,176,87,89,89.34,87.0,91.75,BRGY BARITAN
10,0133A,182,84,98,167,76,91,91.76,90.48,92.86,BRGY BARITAN
11,0134A,191,98,93,161,78,83,84.29,79.59,89.25,BRGY BARITAN
12,0135A,183,92,91,155,76,79,84.7,82.61,86.81,BRGY BARITAN
13,0135B,191,106,85,26,11,15,13.61,10.38,17.65,BRGY BARITAN
14,0135C,177,93,84,24,9,15,13.56,9.68,17.86,BRGY BARITAN
15,0135D,198,97,101,18,6,12,9.09,6.19,11.88,BRGY BARITAN
16,0136A,188,84,104,166,72,94,88.3,85.71,90.38,BRGY BARITAN
17,0136B,186,96,90,176,89,87,94.62,92.71,96.67,BRGY BARITAN
18,0136C,186,105,81,11,6,5,5.91,5.71,6.17,BRGY BARITAN
19,0136D,137,62,75,15,7,8,10.95,11.29,10.67,BRGY BARITAN
20,0137A,188,85,103,182,83,99,96.81,97.65,96.12,BRGY BARITAN
21,0137B,195,89,106,88,35,53,45.13,39.33,50.0,BRGY BARITAN
22,0138A,193,103,90,161,82,79,83.42,79.61,87.78,BRGY BARITAN
23,0139A,178,78,100,171,76,95,96.07,97.44,95.0,BRGY BARITAN
24,0140A,183,84,99,146,71,75,79.78,84.52,75.76,BRGY BARITAN
25,0140B,198,95,103,152,74,78,76.77,77.89,75.73,BRGY BARITAN
26,0141A,183,73,110,180,72,108,98.36,98.63,98.18,BRGY BARITAN
27,0141B,182,75,107,176,72,104,96.7,96.0,97.2,BRGY BARITAN
28,0142A,189,82,107,140,62,78,74.07,75.61,72.9,BRGY BARITAN
29,0142B,194,93,101,83,36,47,42.78,38.71,46.53,BRGY BARITAN
30,0143A,183,85,98,169,79,90,92.35,92.94,91.84,BRGY BARITAN
31,0143B,184,84,100,131,62,69,71.2,73.81,69.0,BRGY BARITAN
32,0144A,193,91,102,186,88,98,96.37,96.7,96.08,BRGY BARITAN
33,0145A,193,92,101,136,66,70,70.47,71.74,69.31,BRGY BARITAN
34,0146A,197,99,98,194,97,97,98.48,97.98,98.98,BRGY BARITAN
35,0147A,192,91,101,185,89,96,96.35,97.8,95.05,BRGY BARITAN
36,0147B,189,80,109,180,79,101,95.24,98.75,92.66,BRGY BARITAN
37,0147C,194,86,108,184,84,100,94.85,97.67,92.59,BRGY BARITAN
38,0147D,193,85,108,187,81,106,96.89,95.29,98.15,BRGY BARITAN
39,0148A,200,81,119,186,72,114,93.0,88.89,95.8,BRGY BARITAN
40,0148B,199,89,110,180,78,102,90.45,87.64,92.73,BRGY BARITAN
41,0148C,200,102,98,33,14,19,16.5,13.73,19.39,BRGY BARITAN
42,0149A,195,97,98,181,87,94,92.82,89.69,95.92,BRGY BARITAN
43,0150A,198,102,96,142,71,71,71.72,69.61,73.96,BRGY BARITAN
44,0151A,200,89,111,133,63,70,66.5,70.79,63.06,BRGY BARITAN
45,0152A,187,88,99,176,82,94,94.12,93.18,94.95,BRGY BARITAN
46,0152B,189,94,95,178,87,91,94.18,92.55,95.79,BRGY BARITAN
47,0152C,180,85,95,28,9,19,15.56,10.59,20.0,BRGY BARITAN
48,0153A,187,86,101,174,84,90,93.05,97.67,89.11,BRGY BARITAN
49,0154A,190,89,101,157,71,86,82.63,79.78,85.15,BRGY BARITAN
50,0549A,199,90,109,123,57,66,61.81,63.33,60.55,BRGY. ACACIA
51,0550A,199,104,95,110,54,56,55.28,51.92,58.95,BRGY. ACACIA
52,0551A,195,101,94,143,78,65,73.33,77.23,69.15,BRGY. ACACIA
53,0552A,179,95,84,134,69,65,74.86,72.63,77.38,BRGY. ACACIA
54,0553A,165,78,87,124,57,67,75.15,73.08,77.01,BRGY. ACACIA
55,0554A,194,98,96,124,57,67,63.92,58.16,69.79,BRGY. ACACIA
56,0555A,191,108,83,169,95,74,88.48,87.96,89.16,BRGY. ACACIA
57,0556A,175,71,104,108,48,60,61.71,67.61,57.69,BRGY. ACACIA
58,0556B,200,90,110,124,56,68,62.0,62.22,61.82,BRGY. ACACIA
59,0557A,197,98,99,179,88,91,90.86,89.8,91.92,BRGY. ACACIA
60,0557B,162,74,88,91,40,51,56.17,54.05,57.95,BRGY. ACACIA
61,0558A,189,78,111,178,76,102,94.18,97.44,91.89,BRGY. ACACIA
62,0558B,175,84,91,0,0,0,0.0,0.0,0.0,BRGY. ACACIA
63,0559A,175,80,95,160,75,85,91.43,93.75,89.47,BRGY. ACACIA
64,0560A,193,94,99,134,66,68,69.43,70.21,68.69,BRGY. ACACIA
65,0561A,197,96,101,193,94,99,97.97,97.92,98.02,BRGY. ACACIA
66,0562A,195,88,107,189,87,102,96.92,98.86,95.33,BRGY. ACACIA
67,0563A,194,101,93,155,79,76,79.9,78.22,81.72,BRGY. ACACIA
68,0564A,186,92,94,143,68,75,76.88,73.91,79.79,BRGY. ACACIA
69,0565A,192,89,103,181,85,96,94.27,95.51,93.2,BRGY. ACACIA
70,0566A,186,85,101,169,75,94,90.86,88.24,93.07,BRGY. ACACIA
71,0567A,177,69,108,144,57,87,81.36,82.61,80.56,BRGY. ACACIA
72,0568A,166,75,91,137,61,76,82.53,81.33,83.52,BRGY. ACACIA
73,0569A,182,97,85,99,46,53,54.4,47.42,62.35,BRGY. ACACIA
74,0570A,199,100,99,121,59,62,60.8,59.0,62.63,BRGY. ACACIA
75,0570B,192,86,106,137,62,75,71.35,72.09,70.75,BRGY. ACACIA
76,0571A,146,73,73,129,68,61,88.36,93.15,83.56,BRGY. ACACIA
77,0572A,145,61,84,141,60,81,97.24,98.36,96.43,BRGY. ACACIA
78,0572B,197,83,114,119,48,71,60.41,57.83,62.28,BRGY. ACACIA
79,0573A,160,79,81,129,62,67,80.63,78.48,82.72,BRGY. ACACIA
80,0573B,147,66,81,146,66,80,99.32,100.0,98.77,BRGY. ACACIA
81,0574A,188,80,108,111,51,60,59.04,63.75,55.56,BRGY. ACACIA
82,0155A,190,94,96,181,92,89,95.26,97.87,92.71,BRGY. BAYAN BAYANAN
83,0155B,192,80,112,170,70,100,88.54,87.5,89.29,BRGY. BAYAN BAYANAN
84,0155C,194,110,84,118,72,46,60.82,65.45,54.76,BRGY. BAYAN BAYANAN
85,0156A,199,90,109,175,82,93,87.94,91.11,85.32,BRGY. BAYAN BAYANAN
86,0156B,185,94,91,171,87,84,92.43,92.55,92.31,BRGY. BAYAN BAYANAN
87,0157A,198,90,108,177,79,98,89.39,87.78,90.74,BRGY. BAYAN BAYANAN
88,0157B,185,96,89,129,68,61,69.73,70.83,68.54,BRGY. BAYAN BAYANAN
89,0158A,200,82,118,162,70,92,81.0,85.37,77.97,BRGY. BAYAN BAYANAN
90,0159A,191,87,104,150,70,80,78.53,80.46,76.92,BRGY. BAYAN BAYANAN
91,0159B,188,98,90,182,97,85,96.81,98.98,94.44,BRGY. BAYAN BAYANAN
92,0160A,183,89,94,159,77,82,86.89,86.52,87.23,BRGY. BAYAN BAYANAN
93,0161A,195,96,99,173,86,87,88.72,89.58,87.88,BRGY. BAYAN BAYANAN
94,0162A,200,99,101,138,70,68,69.0,70.71,67.33,BRGY. BAYAN BAYANAN
95,0162B,200,104,96,7,3,4,3.5,2.88,4.17,BRGY. BAYAN BAYANAN
96,0163A,193,96,97,165,74,91,85.49,77.08,93.81,BRGY. BAYAN BAYANAN
97,0164A,190,104,86,153,81,72,80.53,77.88,83.72,BRGY. BAYAN BAYANAN
98,0165A,194,98,96,184,92,92,94.85,93.88,95.83,BRGY. BAYAN BAYANAN
99,0165B,194,87,107,189,83,106,97.42,95.4,99.07,BRGY. BAYAN BAYANAN
100,0166A,198,115,83,191,112,79,96.46,97.39,95.18,BRGY. BAYAN BAYANAN
101,0167A,192,93,99,167,82,85,86.98,88.17,85.86,BRGY. BAYAN BAYANAN
102,0167B,200,101,99,175,91,84,87.5,90.1,84.85,BRGY. BAYAN BAYANAN
103,0168A,196,83,113,173,75,98,88.27,90.36,86.73,BRGY. BAYAN BAYANAN
104,0169A,189,79,110,175,76,99,92.59,96.2,90.0,BRGY. BAYAN BAYANAN
105,0170A,190,72,118,172,63,109,90.53,87.5,92.37,BRGY. BAYAN BAYANAN
106,0170B,197,112,85,145,84,61,73.6,75.0,71.76,BRGY. BAYAN BAYANAN
107,0170C,196,104,92,5,1,4,2.55,0.96,4.35,BRGY. BAYAN BAYANAN
108,0171A,200,93,107,151,71,80,75.5,76.34,74.77,BRGY. BAYAN BAYANAN
109,0172A,193,82,111,150,62,88,77.72,75.61,79.28,BRGY. BAYAN BAYANAN
110,0172B,193,93,100,160,75,85,82.9,80.65,85.0,BRGY. BAYAN BAYANAN
111,0172C,194,87,107,42,16,26,21.65,18.39,24.3,BRGY. BAYAN BAYANAN
112,0312A,191,77,114,184,75,109,96.34,97.4,95.61,BRGY. CATMON
113,0312B,195,74,121,190,72,118,97.44,97.3,97.52,BRGY. CATMON
114,0312C,192,87,105,177,82,95,92.19,94.25,90.48,BRGY. CATMON
115,0312D,188,88,100,184,86,98,97.87,97.73,98.0,BRGY. CATMON
116,0312E,191,75,116,3,0,3,1.57,0.0,2.59,BRGY. CATMON
117,0313A,199,75,124,184,70,114,92.46,93.33,91.94,BRGY. CATMON
118,0313B,193,84,109,173,75,98,89.64,89.29,89.91,BRGY. CATMON
119,0313C,191,81,110,188,81,107,98.43,100.0,97.27,BRGY. CATMON
120,0313D,193,90,103,176,80,96,91.19,88.89,93.2,BRGY. CATMON
121,0313E,192,86,106,172,78,94,89.58,90.7,88.68,BRGY. CATMON
122,0314A,199,78,121,181,74,107,90.95,94.87,88.43,BRGY. CATMON
123,0314B,193,95,98,180,88,92,93.26,92.63,93.88,BRGY. CATMON
124,0314C,195,93,102,186,92,94,95.38,98.92,92.16,BRGY. CATMON
125,0314D,191,85,106,176,80,96,92.15,94.12,90.57,BRGY. CATMON
126,0314E,190,77,113,5,2,3,2.63,2.6,2.65,BRGY. CATMON
127,0315A,188,80,108,171,72,99,90.96,90.0,91.67,BRGY. CATMON
128,0315B,188,90,98,177,84,93,94.15,93.33,94.9,BRGY. CATMON
129,0315C,195,96,99,186,89,97,95.38,92.71,97.98,BRGY. CATMON
130,0315D,192,92,100,189,90,99,98.44,97.83,99.0,BRGY. CATMON
131,0315E,177,76,101,2,1,1,1.13,1.32,0.99,BRGY. CATMON
132,0316A,200,84,116,176,71,105,88.0,84.52,90.52,BRGY. CATMON
133,0316B,200,94,106,168,73,95,84.0,77.66,89.62,BRGY. CATMON
134,0316C,200,103,97,185,95,90,92.5,92.23,92.78,BRGY. CATMON
135,0316D,194,82,112,181,78,103,93.3,95.12,91.96,BRGY. CATMON
136,0316E,200,101,99,15,6,9,7.5,5.94,9.09,BRGY. CATMON
137,0317A,195,90,105,193,89,104,98.97,98.89,99.05,BRGY. CATMON
138,0317B,196,88,108,179,78,101,91.33,88.64,93.52,BRGY. CATMON
139,0317C,191,82,109,181,74,107,94.76,90.24,98.17,BRGY. CATMON
140,0317D,190,96,94,0,0,0,0.0,0.0,0.0,BRGY. CATMON
141,0317E,162,91,71,3,1,2,1.85,1.1,2.82,BRGY. CATMON
142,0318A,191,87,104,184,84,100,96.34,96.55,96.15,BRGY. CATMON
143,0318B,195,73,122,173,61,112,88.72,83.56,91.8,BRGY. CATMON
144,0318C,191,85,106,175,78,97,91.62,91.76,91.51,BRGY. CATMON
145,0318D,185,83,102,182,81,101,98.38,97.59,99.02,BRGY. CATMON
146,0319A,197,82,115,182,78,104,92.39,95.12,90.43,BRGY. CATMON
147,0319B,190,79,111,172,72,100,90.53,91.14,90.09,BRGY. CATMON
148,0319C,191,97,94,188,96,92,98.43,98.97,97.87,BRGY. CATMON
149,0319D,187,77,110,149,63,86,79.68,81.82,78.18,BRGY. CATMON
150,0320A,195,93,102,180,86,94,92.31,92.47,92.16,BRGY. CATMON
151,0320B,193,83,110,164,73,91,84.97,87.95,82.73,BRGY. CATMON
152,0320C,195,96,99,175,90,85,89.74,93.75,85.86,BRGY. CATMON
153,0320D,193,91,102,182,86,96,94.3,94.51,94.12,BRGY. CATMON
154,0320E,187,94,93,178,92,86,95.19,97.87,92.47,BRGY. CATMON
155,0321A,193,89,104,184,85,99,95.34,95.51,95.19,BRGY. CATMON
156,0321B,198,89,109,189,86,103,95.45,96.63,94.5,BRGY. CATMON
157,0321C,196,82,114,187,78,109,95.41,95.12,95.61,BRGY. CATMON
158,0321D,191,88,103,183,83,100,95.81,94.32,97.09,BRGY. CATMON
159,0321E,198,80,118,189,71,118,95.45,88.75,100.0,BRGY. CATMON
160,0321F,193,92,101,3,2,1,1.55,2.17,0.99,BRGY. CATMON
161,0321G,182,94,88,10,4,6,5.49,4.26,6.82,BRGY. CATMON
162,0322A,189,86,103,182,82,100,96.3,95.35,97.09,BRGY. CATMON
163,0322B,195,82,113,181,77,104,92.82,93.9,92.04,BRGY. CATMON
164,0322C,195,96,99,186,91,95,95.38,94.79,95.96,BRGY. CATMON
165,0322D,189,78,111,185,76,109,97.88,97.44,98.2,BRGY. CATMON
166,0322E,188,88,100,179,84,95,95.21,95.45,95.0,BRGY. CATMON
167,0322F,192,81,111,3,2,1,1.56,2.47,0.9,BRGY. CATMON
168,0323A,193,73,120,185,71,114,95.85,97.26,95.0,BRGY. CATMON
169,0323B,191,71,120,184,68,116,96.34,95.77,96.67,BRGY. CATMON
170,0323C,189,77,112,175,72,103,92.59,93.51,91.96,BRGY. CATMON
171,0323D,193,101,92,182,94,88,94.3,93.07,95.65,BRGY. CATMON
172,0323E,178,87,91,0,0,0,0.0,0.0,0.0,BRGY. CATMON
173,0324A,194,83,111,181,79,102,93.3,95.18,91.89,BRGY. CATMON
174,0324B,189,73,116,180,68,112,95.24,93.15,96.55,BRGY. CATMON
175,0324C,194,77,117,189,73,116,97.42,94.81,99.15,BRGY. CATMON
176,0324D,185,90,95,177,84,93,95.68,93.33,97.89,BRGY. CATMON
177,0324E,189,93,96,179,88,91,94.71,94.62,94.79,BRGY. CATMON
178,0324F,196,82,114,2,2,0,1.02,2.44,0.0,BRGY. CATMON
179,0325A,200,98,102,175,86,89,87.5,87.76,87.25,BRGY. CATMON
180,0325B,198,85,113,179,71,108,90.4,83.53,95.58,BRGY. CATMON
181,0325C,179,89,90,158,80,78,88.27,89.89,86.67,BRGY. CATMON
182,0325D,194,94,100,187,90,97,96.39,95.74,97.0,BRGY. CATMON
183,0325E,200,106,94,1,1,0,0.5,0.94,0.0,BRGY. CATMON
184,0325F,195,109,86,6,2,4,3.08,1.83,4.65,BRGY. CATMON
185,0325G,200,86,114,13,4,9,6.5,4.65,7.89,BRGY. CATMON
186,0326A,190,83,107,185,80,105,97.37,96.39,98.13,BRGY. CATMON
187,0326B,195,87,108,179,79,100,91.79,90.8,92.59,BRGY. CATMON
188,0326C,191,86,105,168,77,91,87.96,89.53,86.67,BRGY. CATMON
189,0326D,178,71,107,177,70,107,99.44,98.59,100.0,BRGY. CATMON
190,0326E,154,58,96,3,3,0,1.95,5.17,0.0,BRGY. CATMON
191,0327A,188,89,99,178,84,94,94.68,94.38,94.95,BRGY. CATMON
192,0327B,189,102,87,176,95,81,93.12,93.14,93.1,BRGY. CATMON
193,0327C,195,91,104,192,89,103,98.46,97.8,99.04,BRGY. CATMON
194,0327D,189,94,95,189,94,95,100.0,100.0,100.0,BRGY. CATMON
195,0328A,188,86,102,173,81,92,92.02,94.19,90.2,BRGY. CATMON
196,0328B,192,96,96,173,86,87,90.1,89.58,90.63,BRGY. CATMON
197,0328C,182,90,92,116,59,57,63.74,65.56,61.96,BRGY. CATMON
198,0328D,187,77,110,186,77,109,99.47,100.0,99.09,BRGY. CATMON
199,0328E,191,75,116,4,0,4,2.09,0.0,3.45,BRGY. CATMON
200,0328F,191,89,102,1,0,1,0.52,0.0,0.98,BRGY. CATMON
201,0328G,197,126,71,1,0,1,0.51,0.0,1.41,BRGY. CATMON
202,0329A,199,108,91,180,98,82,90.45,90.74,90.11,BRGY. CATMON
203,0329B,198,83,115,167,67,100,84.34,80.72,86.96,BRGY. CATMON
204,0329C,180,76,104,123,45,78,68.33,59.21,75.0,BRGY. CATMON
205,0329D,187,102,85,9,4,5,4.81,3.92,5.88,BRGY. CATMON
206,0329E,197,148,49,7,5,2,3.55,3.38,4.08,BRGY. CATMON
207,0330A,200,96,104,179,89,90,89.5,92.71,86.54,BRGY. CATMON
208,0330B,181,83,98,161,76,85,88.95,91.57,86.73,BRGY. CATMON
209,0330C,188,84,104,155,70,85,82.45,83.33,81.73,BRGY. CATMON
210,0330D,197,104,93,8,4,4,4.06,3.85,4.3,BRGY. CATMON
211,0330E,166,120,46,10,8,2,6.02,6.67,4.35,BRGY. CATMON
212,0331A,196,92,104,149,75,74,76.02,81.52,71.15,BRGY. CATMON
213,0331B,179,88,91,1,0,1,0.56,0.0,1.1,BRGY. CATMON
214,0331C,170,78,92,5,2,3,2.94,2.56,3.26,BRGY. CATMON
215,0331D,184,105,79,3,1,2,1.63,0.95,2.53,BRGY. CATMON
216,0331E,189,91,98,5,2,3,2.65,2.2,3.06,BRGY. CATMON
217,0331F,197,113,84,6,1,5,3.05,0.88,5.95,BRGY. CATMON
218,0332A,186,82,104,178,77,101,95.7,93.9,97.12,BRGY. CATMON
219,0332B,180,76,104,174,75,99,96.67,98.68,95.19,BRGY. CATMON
220,0332C,188,119,69,0,0,0,0.0,0.0,0.0,BRGY. CATMON
221,0332D,196,93,103,4,2,2,2.04,2.15,1.94,BRGY. CATMON
222,0332E,199,99,100,6,4,2,3.02,4.04,2.0,BRGY. CATMON
223,0333A,196,84,112,186,79,107,94.9,94.05,95.54,BRGY. CATMON
224,0333B,197,79,118,186,72,114,94.42,91.14,96.61,BRGY. CATMON
225,0333C,175,80,95,1,0,1,0.57,0.0,1.05,BRGY. CATMON
226,0333D,188,85,103,2,2,0,1.06,2.35,0.0,BRGY. CATMON
227,0333E,192,78,114,8,2,6,4.17,2.56,5.26,BRGY. CATMON
228,0333F,189,86,103,1,0,1,0.53,0.0,0.97,BRGY. CATMON
229,0334A,200,91,109,184,84,100,92.0,92.31,91.74,BRGY. CATMON
230,0334B,200,88,112,183,82,101,91.5,93.18,90.18,BRGY. CATMON
231,0334C,200,89,111,4,1,3,2.0,1.12,2.7,BRGY. CATMON
232,0334D,192,99,93,1,1,0,0.52,1.01,0.0,BRGY. CATMON
233,0334E,200,90,110,6,3,3,3.0,3.33,2.73,BRGY. CATMON
234,0334F,191,104,87,10,6,4,5.24,5.77,4.6,BRGY. CATMON
235,0335A,189,88,101,176,84,92,93.12,95.45,91.09,BRGY. CATMON
236,0335B,193,93,100,169,78,91,87.56,83.87,91.0,BRGY. CATMON
237,0335C,185,90,95,182,88,94,98.38,97.78,98.95,BRGY. CATMON
238,0335D,183,79,104,150,67,83,81.97,84.81,79.81,BRGY. CATMON
239,0335E,192,111,81,1,0,1,0.52,0.0,1.23,BRGY. CATMON
240,0336A,200,92,108,175,81,94,87.5,88.04,87.04,BRGY. CATMON
241,0336B,199,94,105,162,74,88,81.41,78.72,83.81,BRGY. CATMON
242,0336C,162,28,134,1,1,0,0.62,3.57,0.0,BRGY. CATMON
243,0336D,167,88,79,6,2,4,3.59,2.27,5.06,BRGY. CATMON
244,0336E,200,90,110,11,3,8,5.5,3.33,7.27,BRGY. CATMON
245,0337A,177,80,97,167,73,94,94.35,91.25,96.91,BRGY. CATMON
246,0337B,187,73,114,180,70,110,96.26,95.89,96.49,BRGY. CATMON
247,0337C,174,66,108,170,65,105,97.7,98.48,97.22,BRGY. CATMON
248,0337D,180,79,101,178,78,100,98.89,98.73,99.01,BRGY. CATMON
249,0337E,190,78,112,0,0,0,0.0,0.0,0.0,BRGY. CATMON
250,0337F,195,100,95,4,1,3,2.05,1.0,3.16,BRGY. CATMON
251,0094A,193,79,114,157,58,99,81.35,73.42,86.84,BRGY. CONCEPCION
252,0094B,176,82,94,147,72,75,83.52,87.8,79.79,BRGY. CONCEPCION
253,0094C,176,76,100,142,57,85,80.68,75.0,85.0,BRGY. CONCEPCION
254,0095A,191,91,100,178,80,98,93.19,87.91,98.0,BRGY. CONCEPCION
255,0096A,190,97,93,163,86,77,85.79,88.66,82.8,BRGY. CONCEPCION
256,0097A,184,81,103,154,68,86,83.7,83.95,83.5,BRGY. CONCEPCION
257,0097B,176,69,107,149,57,92,84.66,82.61,85.98,BRGY. CONCEPCION
258,0097C,171,95,76,146,80,66,85.38,84.21,86.84,BRGY. CONCEPCION
259,0098A,193,98,95,180,91,89,93.26,92.86,93.68,BRGY. CONCEPCION
260,0098B,194,84,110,13,5,8,6.7,5.95,7.27,BRGY. CONCEPCION
261,0099A,195,94,101,176,85,91,90.26,90.43,90.1,BRGY. CONCEPCION
262,0099B,176,84,92,165,80,85,93.75,95.24,92.39,BRGY. CONCEPCION
263,0100A,191,89,102,170,79,91,89.01,88.76,89.22,BRGY. CONCEPCION
264,0100B,180,83,97,124,54,70,68.89,65.06,72.16,BRGY. CONCEPCION
265,0100C,180,86,94,133,63,70,73.89,73.26,74.47,BRGY. CONCEPCION
266,0101A,185,86,99,129,57,72,69.73,66.28,72.73,BRGY. CONCEPCION
267,0101B,177,89,88,117,52,65,66.1,58.43,73.86,BRGY. CONCEPCION
268,0102A,190,91,99,168,80,88,88.42,87.91,88.89,BRGY. CONCEPCION
269,0103A,186,83,103,157,69,88,84.41,83.13,85.44,BRGY. CONCEPCION
270,0104A,195,86,109,144,65,79,73.85,75.58,72.48,BRGY. CONCEPCION
271,0105A,187,93,94,155,79,76,82.89,84.95,80.85,BRGY. CONCEPCION
272,0106A,190,82,108,149,66,83,78.42,80.49,76.85,BRGY. CONCEPCION
273,0107A,191,104,87,149,77,72,78.01,74.04,82.76,BRGY. CONCEPCION
274,0107B,175,89,86,157,77,80,89.71,86.52,93.02,BRGY. CONCEPCION
275,0108A,185,83,102,158,71,87,85.41,85.54,85.29,BRGY. CONCEPCION
276,0109A,200,92,108,189,87,102,94.5,94.57,94.44,BRGY. CONCEPCION
277,0110A,195,91,104,178,84,94,91.28,92.31,90.38,BRGY. CONCEPCION
278,0111A,195,99,96,180,91,89,92.31,91.92,92.71,BRGY. CONCEPCION
279,0111B,194,94,100,178,85,93,91.75,90.43,93.0,BRGY. CONCEPCION
280,0112A,187,81,106,174,76,98,93.05,93.83,92.45,BRGY. CONCEPCION
281,0113A,184,91,93,153,75,78,83.15,82.42,83.87,BRGY. CONCEPCION
282,0114A,194,78,116,164,67,97,84.54,85.9,83.62,BRGY. CONCEPCION
283,0114B,183,86,97,142,69,73,77.6,80.23,75.26,BRGY. CONCEPCION
284,0115A,198,81,117,145,62,83,73.23,76.54,70.94,BRGY. CONCEPCION
285,0116A,174,79,95,129,58,71,74.14,73.42,74.74,BRGY. CONCEPCION
286,0116B,195,89,106,9,3,6,4.62,3.37,5.66,BRGY. CONCEPCION
287,0117A,194,90,104,151,76,75,77.84,84.44,72.12,BRGY. CONCEPCION
288,0117B,122,60,62,4,3,1,3.28,5.0,1.61,BRGY. CONCEPCION
289,0118A,193,108,85,133,72,61,68.91,66.67,71.76,BRGY. CONCEPCION
290,0118B,191,95,96,140,70,70,73.3,73.68,72.92,BRGY. CONCEPCION
291,0118C,196,100,95,146,78,67,74.49,78.0,70.53,BRGY. CONCEPCION
292,0119A,195,82,113,186,75,111,95.38,91.46,98.23,BRGY. CONCEPCION
293,0120A,194,76,118,158,60,98,81.44,78.95,83.05,BRGY. CONCEPCION
294,0121A,182,92,90,174,84,90,95.6,91.3,100.0,BRGY. CONCEPCION
295,0121B,184,107,77,60,36,24,32.61,33.64,31.17,BRGY. CONCEPCION
296,0122A,178,86,92,147,69,78,82.58,80.23,84.78,BRGY. CONCEPCION
297,0122B,199,110,89,12,4,8,6.03,3.64,8.99,BRGY. CONCEPCION
298,0123A,194,87,107,186,82,104,95.88,94.25,97.2,BRGY. CONCEPCION
299,0123B,199,91,108,189,87,102,94.97,95.6,94.44,BRGY. CONCEPCION
300,0124A,185,72,113,167,68,99,90.27,94.44,87.61,BRGY. CONCEPCION
301,0124B,27,12,15,1,0,1,3.7,0.0,6.67,BRGY. CONCEPCION
302,0125A,196,106,90,185,99,86,94.39,93.4,95.56,BRGY. CONCEPCION
303,0125B,189,83,106,154,67,87,81.48,80.72,82.08,BRGY. CONCEPCION
304,0125C,198,102,96,3,1,2,1.52,0.98,2.08,BRGY. CONCEPCION
305,0225A,199,103,96,154,84,70,77.39,81.55,72.92,BRGY. DAMPALIT
306,0225B,189,94,95,151,75,76,79.89,79.79,80.0,BRGY. DAMPALIT
307,0226A,192,85,107,137,62,75,71.35,72.94,70.09,BRGY. DAMPALIT
308,0226B,177,71,106,132,54,78,74.58,76.06,73.58,BRGY. DAMPALIT
309,0227A,178,87,91,125,64,61,70.22,73.56,67.03,BRGY. DAMPALIT
310,0227B,164,73,91,86,40,46,52.44,54.79,50.55,BRGY. DAMPALIT
311,0228A,169,76,93,123,56,67,72.78,73.68,72.04,BRGY. DAMPALIT
312,0229A,188,93,95,109,53,56,57.98,56.99,58.95,BRGY. DAMPALIT
313,0229B,153,86,67,8,7,1,5.23,8.14,1.49,BRGY. DAMPALIT
314,0230A,165,89,76,116,64,52,70.3,71.91,68.42,BRGY. DAMPALIT
315,0230B,155,77,78,94,44,50,60.65,57.14,64.1,BRGY. DAMPALIT
316,0231A,159,60,99,107,42,65,67.3,70.0,65.66,BRGY. DAMPALIT
317,0231B,198,104,94,12,4,8,6.06,3.85,8.51,BRGY. DAMPALIT
318,0232A,166,90,76,137,78,59,82.53,86.67,77.63,BRGY. DAMPALIT
319,0232B,164,77,87,123,60,63,75.0,77.92,72.41,BRGY. DAMPALIT
320,0233A,179,85,94,107,54,53,59.78,63.53,56.38,BRGY. DAMPALIT
321,0233B,157,76,81,8,2,6,5.1,2.63,7.41,BRGY. DAMPALIT
322,0234A,198,94,104,146,67,79,73.74,71.28,75.96,BRGY. DAMPALIT
323,0234B,188,83,105,4,0,4,2.13,0.0,3.81,BRGY. DAMPALIT
324,0235A,195,89,106,137,59,78,70.26,66.29,73.58,BRGY. DAMPALIT
325,0235B,193,97,96,68,38,30,35.23,39.18,31.25,BRGY. DAMPALIT
326,0236A,192,86,106,142,65,77,73.96,75.58,72.64,BRGY. DAMPALIT
327,0237A,178,80,98,154,66,88,86.52,82.5,89.8,BRGY. DAMPALIT
328,0238A,179,83,96,131,60,71,73.18,72.29,73.96,BRGY. DAMPALIT
329,0238B,177,77,100,11,3,8,6.21,3.9,8.0,BRGY. DAMPALIT
330,0239A,188,82,106,158,70,88,84.04,85.37,83.02,BRGY. DAMPALIT
331,0240A,185,83,102,157,72,85,84.86,86.75,83.33,BRGY. DAMPALIT
332,0240B,189,94,95,134,72,62,70.9,76.6,65.26,BRGY. DAMPALIT
333,0241A,183,88,95,144,64,80,78.69,72.73,84.21,BRGY. DAMPALIT
334,0242A,193,91,102,183,87,96,94.82,95.6,94.12,BRGY. DAMPALIT
335,0243A,193,82,111,162,68,94,83.94,82.93,84.68,BRGY. DAMPALIT
336,0244A,197,88,109,159,72,87,80.71,81.82,79.82,BRGY. DAMPALIT
337,0244B,194,84,110,129,56,73,66.49,66.67,66.36,BRGY. DAMPALIT
338,0244C,176,83,93,131,61,70,74.43,73.49,75.27,BRGY. DAMPALIT
339,0245A,194,92,102,142,67,75,73.2,72.83,73.53,BRGY. DAMPALIT
340,0246A,173,92,81,140,71,69,80.92,77.17,85.19,BRGY. DAMPALIT
341,0246B,176,76,100,135,53,82,76.7,69.74,82.0,BRGY. DAMPALIT
342,0247A,195,90,105,139,62,77,71.28,68.89,73.33,BRGY. DAMPALIT
343,0247B,173,97,76,8,4,4,4.62,4.12,5.26,BRGY. DAMPALIT
344,0248A,188,94,94,148,72,76,78.72,76.6,80.85,BRGY. DAMPALIT
345,0248B,174,82,92,107,43,64,61.49,52.44,69.57,BRGY. DAMPALIT
346,0249A,192,100,92,138,72,66,71.88,72.0,71.74,BRGY. DAMPALIT
347,0250A,185,88,97,111,51,60,60.0,57.95,61.86,BRGY. DAMPALIT
348,0251A,184,87,97,140,63,77,76.09,72.41,79.38,BRGY. DAMPALIT
349,0251B,175,92,83,140,72,68,80.0,78.26,81.93,BRGY. DAMPALIT
350,0251C,131,70,61,7,2,5,5.34,2.86,8.2,BRGY. DAMPALIT
351,0252A,167,89,78,131,70,61,78.44,78.65,78.21,BRGY. DAMPALIT
352,0253A,177,74,103,123,47,76,69.49,63.51,73.79,BRGY. DAMPALIT
353,0254A,176,83,93,121,57,64,68.75,68.67,68.82,BRGY. DAMPALIT
354,0173A,179,89,90,134,65,69,74.86,73.03,76.67,BRGY. FLORES
355,0173B,159,72,87,103,49,54,64.78,68.06,62.07,BRGY. FLORES
356,0174A,159,67,92,101,42,59,63.52,62.69,64.13,BRGY. FLORES
357,0175A,189,99,90,164,86,78,86.77,86.87,86.67,BRGY. FLORES
358,0175B,168,83,85,142,72,70,84.52,86.75,82.35,BRGY. FLORES
359,0176A,176,78,98,152,67,85,86.36,85.9,86.73,BRGY. FLORES
360,0177A,185,87,98,135,59,76,72.97,67.82,77.55,BRGY. FLORES
361,0177B,194,91,103,110,49,61,56.7,53.85,59.22,BRGY. FLORES
362,0178A,153,71,82,128,62,66,83.66,87.32,80.49,BRGY. FLORES
363,0178B,153,70,83,126,57,69,82.35,81.43,83.13,BRGY. FLORES
364,0179A,159,72,87,134,61,73,84.28,84.72,83.91,BRGY. FLORES
365,0180A,177,75,102,134,54,80,75.71,72.0,78.43,BRGY. FLORES
366,0181A,177,91,86,150,75,75,84.75,82.42,87.21,BRGY. FLORES
367,0182A,195,100,95,187,95,92,95.9,95.0,96.84,BRGY. FLORES
368,0183A,194,84,110,162,71,91,83.51,84.52,82.73,BRGY. FLORES
369,0183B,194,105,89,175,98,77,90.21,93.33,86.52,BRGY. FLORES
370,0184A,188,86,102,142,69,73,75.53,80.23,71.57,BRGY. FLORES
371,0184B,191,95,96,145,73,72,75.92,76.84,75.0,BRGY. FLORES
372,0200A,197,81,116,188,75,113,95.43,92.59,97.41,BRGY. HULONG DUHAT
373,0200B,190,91,99,178,88,90,93.68,96.7,90.91,BRGY. HULONG DUHAT
374,0201A,192,93,99,181,89,92,94.27,95.7,92.93,BRGY. HULONG DUHAT
375,0201B,187,83,104,170,72,98,90.91,86.75,94.23,BRGY. HULONG DUHAT
376,0202A,189,91,98,172,82,90,91.01,90.11,91.84,BRGY. HULONG DUHAT
377,0202B,185,111,74,177,106,71,95.68,95.5,95.95,BRGY. HULONG DUHAT
378,0203A,190,106,84,171,97,74,90.0,91.51,88.1,BRGY. HULONG DUHAT
379,0203B,190,101,89,186,99,87,97.89,98.02,97.75,BRGY. HULONG DUHAT
380,0204A,188,89,99,179,83,96,95.21,93.26,96.97,BRGY. HULONG DUHAT
381,0204B,184,96,88,101,52,49,54.89,54.17,55.68,BRGY. HULONG DUHAT
382,0205A,191,96,95,180,92,88,94.24,95.83,92.63,BRGY. HULONG DUHAT
383,0205B,185,102,83,141,81,60,76.22,79.41,72.29,BRGY. HULONG DUHAT
384,0206A,191,91,100,174,83,91,91.1,91.21,91.0,BRGY. HULONG DUHAT
385,0206B,193,89,104,3,1,2,1.55,1.12,1.92,BRGY. HULONG DUHAT
386,0207A,194,77,117,169,66,103,87.11,85.71,88.03,BRGY. HULONG DUHAT
387,0207B,188,89,99,180,87,93,95.74,97.75,93.94,BRGY. HULONG DUHAT
388,0208A,193,86,107,177,81,96,91.71,94.19,89.72,BRGY. HULONG DUHAT
389,0208B,199,94,105,9,3,6,4.52,3.19,5.71,BRGY. HULONG DUHAT
390,0209A,196,91,105,167,78,89,85.2,85.71,84.76,BRGY. HULONG DUHAT
391,0209B,188,85,103,166,75,91,88.3,88.24,88.35,BRGY. HULONG DUHAT
392,0210A,189,81,108,174,76,98,92.06,93.83,90.74,BRGY. HULONG DUHAT
393,0210B,190,89,101,180,81,99,94.74,91.01,98.02,BRGY. HULONG DUHAT
394,0211A,190,84,106,185,83,102,97.37,98.81,96.23,BRGY. HULONG DUHAT
395,0211B,190,90,100,158,80,78,83.16,88.89,78.0,BRGY. HULONG DUHAT
396,0212A,187,102,85,171,92,79,91.44,90.2,92.94,BRGY. HULONG DUHAT
397,0212B,192,89,103,160,78,82,83.33,87.64,79.61,BRGY. HULONG DUHAT
398,0213A,195,92,103,163,78,85,83.59,84.78,82.52,BRGY. HULONG DUHAT
399,0213B,193,88,105,172,78,94,89.12,88.64,89.52,BRGY. HULONG DUHAT
400,0214A,197,97,100,176,86,90,89.34,88.66,90.0,BRGY. HULONG DUHAT
401,0215A,192,89,103,181,85,96,94.27,95.51,93.2,BRGY. HULONG DUHAT
402,0216A,197,104,93,186,96,90,94.42,92.31,96.77,BRGY. HULONG DUHAT
403,0216B,195,103,92,176,92,84,90.26,89.32,91.3,BRGY. HULONG DUHAT
404,0216C,175,93,82,5,2,3,2.86,2.15,3.66,BRGY. HULONG DUHAT
405,0217A,186,90,95,169,83,85,90.86,92.22,89.47,BRGY. HULONG DUHAT
406,0217B,190,89,101,161,76,85,84.74,85.39,84.16,BRGY. HULONG DUHAT
407,0218A,198,94,104,157,74,83,79.29,78.72,79.81,BRGY. HULONG DUHAT
408,0218B,194,85,109,13,6,7,6.7,7.06,6.42,BRGY. HULONG DUHAT
409,0218C,200,86,114,16,5,11,8.0,5.81,9.65,BRGY. HULONG DUHAT
410,0219A,196,76,120,173,68,105,88.27,89.47,87.5,BRGY. HULONG DUHAT
411,0219B,183,90,93,173,87,86,94.54,96.67,92.47,BRGY. HULONG DUHAT
412,0219C,153,85,68,4,2,2,2.61,2.35,2.94,BRGY. HULONG DUHAT
413,0220A,192,97,95,175,84,91,91.15,86.6,95.79,BRGY. HULONG DUHAT
414,0220B,189,83,106,168,67,101,88.89,80.72,95.28,BRGY. HULONG DUHAT
415,0221A,200,98,102,171,84,87,85.5,85.71,85.29,BRGY. HULONG DUHAT
416,0221B,199,92,107,167,74,93,83.92,80.43,86.92,BRGY. HULONG DUHAT
417,0221C,193,102,91,12,2,10,6.22,1.96,10.99,BRGY. HULONG DUHAT
418,0221D,175,89,86,26,9,17,14.86,10.11,19.77,BRGY. HULONG DUHAT
419,0221E,75,43,32,14,9,5,18.67,20.93,15.63,BRGY. HULONG DUHAT
420,0222A,189,83,106,183,78,105,96.83,93.98,99.06,BRGY. HULONG DUHAT
421,0222B,185,95,90,181,93,88,97.84,97.89,97.78,BRGY. HULONG DUHAT
422,0222C,185,87,98,99,51,48,53.51,58.62,48.98,BRGY. HULONG DUHAT
423,0223A,198,81,117,169,65,104,85.35,80.25,88.89,BRGY. HULONG DUHAT
424,0223B,193,96,97,181,91,90,93.78,94.79,92.78,BRGY. HULONG DUHAT
425,0223C,148,71,77,14,4,10,9.46,5.63,12.99,BRGY. HULONG DUHAT
426,0224A,192,87,105,172,77,95,89.58,88.51,90.48,BRGY. HULONG DUHAT
427,0224B,181,78,103,158,71,87,87.29,91.03,84.47,BRGY. HULONG DUHAT
428,0224C,153,82,71,7,4,3,4.58,4.88,4.23,BRGY. HULONG DUHAT
429,0068A,197,108,89,181,96,85,91.88,88.89,95.51,BRGY. IBABA
430,0068B,180,108,72,9,5,4,5.0,4.63,5.56,BRGY. IBABA
431,0069A,193,87,106,176,77,99,91.19,88.51,93.4,BRGY. IBABA
432,0069B,192,90,102,179,83,96,93.23,92.22,94.12,BRGY. IBABA
433,0069C,189,76,113,175,69,106,92.59,90.79,93.81,BRGY. IBABA
434,0070A,199,96,103,161,81,80,80.9,84.38,77.67,BRGY. IBABA
435,0071A,189,81,108,171,77,94,90.48,95.06,87.04,BRGY. IBABA
436,0072A,190,86,104,169,77,92,88.95,89.53,88.46,BRGY. IBABA
437,0073A,194,95,99,148,72,76,76.29,75.79,76.77,BRGY. IBABA
438,0074A,194,82,112,118,51,67,60.82,62.2,59.82,BRGY. IBABA
439,0075A,187,91,96,154,74,80,82.35,81.32,83.33,BRGY. IBABA
440,0076A,194,85,109,179,80,99,92.27,94.12,90.83,BRGY. IBABA
441,0076B,192,103,89,125,72,53,65.1,69.9,59.55,BRGY. IBABA
442,0077A,194,80,114,181,75,106,93.3,93.75,92.98,BRGY. IBABA
443,0077B,189,98,91,175,92,83,92.59,93.88,91.21,BRGY. IBABA
444,0078A,191,92,99,164,76,88,85.86,82.61,88.89,BRGY. IBABA
445,0079A,192,100,92,116,60,56,60.42,60.0,60.87,BRGY. IBABA
446,0080A,188,88,100,172,81,91,91.49,92.05,91.0,BRGY. IBABA
447,0081A,183,94,89,171,86,85,93.44,91.49,95.51,BRGY. IBABA
448,0082A,187,88,99,157,71,86,83.96,80.68,86.87,BRGY. IBABA
449,0083A,186,99,87,156,83,73,83.87,83.84,83.91,BRGY. IBABA
450,0084A,180,78,102,149,61,88,82.78,78.21,86.27,BRGY. IBABA
451,0085A,198,113,85,169,94,75,85.35,83.19,88.24,BRGY. IBABA
452,0085B,196,95,101,154,80,74,78.57,84.21,73.27,BRGY. IBABA
453,0086A,200,109,91,156,82,74,78.0,75.23,81.32,BRGY. IBABA
454,0086B,190,105,85,145,86,59,76.32,81.9,69.41,BRGY. IBABA
455,0086C,183,92,91,133,75,58,72.68,81.52,63.74,BRGY. IBABA
456,0087A,197,82,115,157,59,98,79.7,71.95,85.22,BRGY. IBABA
457,0088A,185,99,86,136,71,65,73.51,71.72,75.58,BRGY. IBABA
458,0089A,192,74,118,161,59,102,83.85,79.73,86.44,BRGY. IBABA
459,0090A,188,84,104,154,70,84,81.91,83.33,80.77,BRGY. IBABA
460,0091A,192,88,104,156,74,82,81.25,84.09,78.85,BRGY. IBABA
461,0092A,192,92,100,169,80,89,88.02,86.96,89.0,BRGY. IBABA
462,0093A,198,93,105,165,76,89,83.33,81.72,84.76,BRGY. IBABA
463,0093B,180,104,76,6,4,2,3.33,3.85,2.63,BRGY. IBABA
464,0093C,147,76,71,13,6,7,8.84,7.89,9.86,BRGY. IBABA
465,0418A,192,99,93,189,97,92,98.44,97.98,98.92,BRGY. LONGOS
466,0418B,188,96,92,182,91,91,96.81,94.79,98.91,BRGY. LONGOS
467,0419A,193,98,95,183,92,91,94.82,93.88,95.79,BRGY. LONGOS
468,0419B,163,63,100,2,0,2,1.23,0.0,2.0,BRGY. LONGOS
469,0419C,158,83,75,2,1,1,1.27,1.2,1.33,BRGY. LONGOS
470,0420A,193,91,102,185,84,101,95.85,92.31,99.02,BRGY. LONGOS
471,0420B,168,89,79,1,0,1,0.6,0.0,1.27,BRGY. LONGOS
472,0421A,184,108,76,151,88,63,82.07,81.48,82.89,BRGY. LONGOS
473,0421B,180,81,99,149,62,87,82.78,76.54,87.88,BRGY. LONGOS
474,0421C,184,89,95,125,58,67,67.93,65.17,70.53,BRGY. LONGOS
475,0422A,182,76,106,150,58,92,82.42,76.32,86.79,BRGY. LONGOS
476,0422B,184,82,102,145,65,80,78.8,79.27,78.43,BRGY. LONGOS
477,0423A,177,73,104,133,54,79,75.14,73.97,75.96,BRGY. LONGOS
478,0424A,183,87,96,175,86,89,95.63,98.85,92.71,BRGY. LONGOS
479,0424B,181,79,102,154,66,88,85.08,83.54,86.27,BRGY. LONGOS
480,0425A,190,83,107,161,70,91,84.74,84.34,85.05,BRGY. LONGOS
481,0425B,192,80,112,137,59,78,71.35,73.75,69.64,BRGY. LONGOS
482,0425C,182,84,98,128,57,71,70.33,67.86,72.45,BRGY. LONGOS
483,0426A,192,98,94,154,76,78,80.21,77.55,82.98,BRGY. LONGOS
484,0426B,192,87,105,59,30,29,30.73,34.48,27.62,BRGY. LONGOS
485,0427A,195,89,106,151,68,83,77.44,76.4,78.3,BRGY. LONGOS
486,0427B,199,100,99,6,3,3,3.02,3.0,3.03,BRGY. LONGOS
487,0427C,181,85,96,7,2,5,3.87,2.35,5.21,BRGY. LONGOS
488,0428A,189,87,102,132,62,70,69.84,71.26,68.63,BRGY. LONGOS
489,0429A,192,84,108,148,65,83,77.08,77.38,76.85,BRGY. LONGOS
490,0429B,183,92,91,137,67,70,74.86,72.83,76.92,BRGY. LONGOS
491,0429C,187,91,96,161,75,86,86.1,82.42,89.58,BRGY. LONGOS
492,0430A,193,93,100,179,88,91,92.75,94.62,91.0,BRGY. LONGOS
493,0430B,185,91,94,174,89,85,94.05,97.8,90.43,BRGY. LONGOS
494,0431A,196,97,99,179,89,90,91.33,91.75,90.91,BRGY. LONGOS
495,0431B,189,85,104,185,85,100,97.88,100.0,96.15,BRGY. LONGOS
496,0432A,194,92,102,173,80,93,89.18,86.96,91.18,BRGY. LONGOS
497,0433A,172,88,84,154,79,75,89.53,89.77,89.29,BRGY. LONGOS
498,0434A,164,67,97,138,58,80,84.15,86.57,82.47,BRGY. LONGOS
499,0435A,164,77,87,131,56,75,79.88,72.73,86.21,BRGY. LONGOS
500,0436A,192,85,107,158,70,88,82.29,82.35,82.24,BRGY. LONGOS
501,0436B,178,87,91,134,63,71,75.28,72.41,78.02,BRGY. LONGOS
502,0436C,195,91,104,1,0,1,0.51,0.0,0.96,BRGY. LONGOS
503,0437A,180,86,94,144,65,79,80.0,75.58,84.04,BRGY. LONGOS
504,0437B,183,88,95,162,73,89,88.52,82.95,93.68,BRGY. LONGOS
505,0437C,176,89,87,2,1,1,1.14,1.12,1.15,BRGY. LONGOS
506,0438A,195,87,108,178,80,98,91.28,91.95,90.74,BRGY. LONGOS
507,0438B,190,90,100,168,76,92,88.42,84.44,92.0,BRGY. LONGOS
508,0438C,185,90,95,155,77,78,83.78,85.56,82.11,BRGY. LONGOS
509,0438D,185,85,100,155,66,89,83.78,77.65,89.0,BRGY. LONGOS
510,0439A,189,69,120,158,61,97,83.6,88.41,80.83,BRGY. LONGOS
511,0439B,194,95,99,166,80,86,85.57,84.21,86.87,BRGY. LONGOS
512,0440A,189,95,94,156,78,78,82.54,82.11,82.98,BRGY. LONGOS
513,0440B,179,75,104,153,65,88,85.47,86.67,84.62,BRGY. LONGOS
514,0441A,166,87,79,121,64,57,72.89,73.56,72.15,BRGY. LONGOS
515,0441B,179,86,93,110,49,61,61.45,56.98,65.59,BRGY. LONGOS
516,0441C,188,95,93,159,80,79,84.57,84.21,84.95,BRGY. LONGOS
517,0442A,181,69,112,175,67,108,96.69,97.1,96.43,BRGY. LONGOS
518,0442B,192,88,104,172,80,92,89.58,90.91,88.46,BRGY. LONGOS
519,0442C,190,85,105,170,75,95,89.47,88.24,90.48,BRGY. LONGOS
520,0442D,188,78,110,165,66,99,87.77,84.62,90.0,BRGY. LONGOS
521,0442E,171,84,87,159,77,82,92.98,91.67,94.25,BRGY. LONGOS
522,0443A,166,77,89,94,42,52,56.63,54.55,58.43,BRGY. LONGOS
523,0443B,184,92,92,116,60,56,63.04,65.22,60.87,BRGY. LONGOS
524,0443C,171,86,85,98,52,46,57.31,60.47,54.12,BRGY. LONGOS
525,0443D,173,81,92,87,40,47,50.29,49.38,51.09,BRGY. LONGOS
526,0444A,194,85,109,124,50,74,63.92,58.82,67.89,BRGY. LONGOS
527,0444B,190,93,97,3,1,2,1.58,1.08,2.06,BRGY. LONGOS
528,0444C,87,43,44,3,1,2,3.45,2.33,4.55,BRGY. LONGOS
529,0445A,176,80,96,125,47,78,71.02,58.75,81.25,BRGY. LONGOS
530,0445B,200,92,108,132,59,73,66.0,64.13,67.59,BRGY. LONGOS
531,0445C,155,63,92,103,41,62,66.45,65.08,67.39,BRGY. LONGOS
532,0445D,200,86,114,97,43,54,48.5,50.0,47.37,BRGY. LONGOS
533,0445E,159,87,72,148,81,67,93.08,93.1,93.06,BRGY. LONGOS
534,0446A,197,94,103,157,68,89,79.7,72.34,86.41,BRGY. LONGOS
535,0446B,188,93,95,112,47,65,59.57,50.54,68.42,BRGY. LONGOS
536,0446C,160,74,86,114,53,61,71.25,71.62,70.93,BRGY. LONGOS
537,0446D,180,81,99,121,54,67,67.22,66.67,67.68,BRGY. LONGOS
538,0446E,187,88,99,182,86,96,97.33,97.73,96.97,BRGY. LONGOS
539,0447A,190,76,114,179,72,107,94.21,94.74,93.86,BRGY. LONGOS
540,0447B,187,88,99,0,0,0,0.0,0.0,0.0,BRGY. LONGOS
541,0448A,188,83,105,165,72,93,87.77,86.75,88.57,BRGY. LONGOS
542,0448B,188,82,106,166,71,95,88.3,86.59,89.62,BRGY. LONGOS
543,0448C,189,104,85,177,98,79,93.65,94.23,92.94,BRGY. LONGOS
544,0449A,189,74,115,169,63,106,89.42,85.14,92.17,BRGY. LONGOS
545,0449B,193,67,126,1,1,0,0.52,1.49,0.0,BRGY. LONGOS
546,0450A,192,95,97,160,79,81,83.33,83.16,83.51,BRGY. LONGOS
547,0450B,195,90,105,151,69,82,77.44,76.67,78.1,BRGY. LONGOS
548,0450C,183,90,93,171,81,90,93.44,90.0,96.77,BRGY. LONGOS
549,0451A,186,80,106,155,67,88,83.33,83.75,83.02,BRGY. LONGOS
550,0451B,193,88,105,158,69,89,81.87,78.41,84.76,BRGY. LONGOS
551,0452A,199,80,119,190,74,116,95.48,92.5,97.48,BRGY. LONGOS
552,0452B,186,72,114,49,16,33,26.34,22.22,28.95,BRGY. LONGOS
553,0452C,196,104,92,3,1,2,1.53,0.96,2.17,BRGY. LONGOS
554,0452D,174,93,81,3,2,1,1.72,2.15,1.23,BRGY. LONGOS
555,0453A,193,88,105,185,84,101,95.85,95.45,96.19,BRGY. LONGOS
556,0453B,188,84,104,171,74,97,90.96,88.1,93.27,BRGY. LONGOS
557,0453C,187,86,101,171,81,90,91.44,94.19,89.11,BRGY. LONGOS
558,0454A,184,83,101,171,79,92,92.93,95.18,91.09,BRGY. LONGOS
559,0454B,192,82,110,185,80,105,96.35,97.56,95.45,BRGY. LONGOS
560,0455A,197,89,108,194,88,106,98.48,98.88,98.15,BRGY. LONGOS
561,0455B,196,91,105,3,2,1,1.53,2.2,0.95,BRGY. LONGOS
562,0456A,194,89,105,178,80,98,91.75,89.89,93.33,BRGY. LONGOS
563,0456B,187,98,89,122,65,57,65.24,66.33,64.04,BRGY. LONGOS
564,0456C,188,79,109,109,53,56,57.98,67.09,51.38,BRGY. LONGOS
565,0456D,182,78,104,0,0,0,0.0,0.0,0.0,BRGY. LONGOS
566,0457A,197,101,96,116,59,57,58.88,58.42,59.38,BRGY. LONGOS
567,0457B,190,91,99,186,89,97,97.89,97.8,97.98,BRGY. LONGOS
568,0457C,190,81,109,113,49,64,59.47,60.49,58.72,BRGY. LONGOS
569,0458A,194,82,112,172,70,102,88.66,85.37,91.07,BRGY. LONGOS
570,0458B,191,90,101,159,76,83,83.25,84.44,82.18,BRGY. LONGOS
571,0458C,195,94,101,32,10,22,16.41,10.64,21.78,BRGY. LONGOS
572,0458D,195,99,96,0,0,0,0.0,0.0,0.0,BRGY. LONGOS
573,0459A,191,88,103,164,75,89,85.86,85.23,86.41,BRGY. LONGOS
574,0459B,192,96,96,153,73,80,79.69,76.04,83.33,BRGY. LONGOS
575,0459C,200,90,110,147,60,87,73.5,66.67,79.09,BRGY. LONGOS
576,0460A,195,82,113,144,55,89,73.85,67.07,78.76,BRGY. LONGOS
577,0460B,188,100,88,150,83,67,79.79,83.0,76.14,BRGY. LONGOS
578,0460C,189,87,102,185,84,101,97.88,96.55,99.02,BRGY. LONGOS
579,0461A,188,84,104,177,82,95,94.15,97.62,91.35,BRGY. LONGOS
580,0461B,194,97,97,173,88,85,89.18,90.72,87.63,BRGY. LONGOS
581,0461C,183,89,94,182,89,93,99.45,100.0,98.94,BRGY. LONGOS
582,0462A,191,97,94,145,70,75,75.92,72.16,79.79,BRGY. LONGOS
583,0462B,189,93,96,161,81,80,85.19,87.1,83.33,BRGY. LONGOS
584,0463A,192,75,117,178,70,108,92.71,93.33,92.31,BRGY. LONGOS
585,0463B,187,87,100,165,76,89,88.24,87.36,89.0,BRGY. LONGOS
586,0464A,185,83,102,170,79,91,91.89,95.18,89.22,BRGY. LONGOS
587,0464B,191,90,101,105,53,52,54.97,58.89,51.49,BRGY. LONGOS
588,0465A,180,84,96,122,55,67,67.78,65.48,69.79,BRGY. LONGOS
589,0465B,189,90,99,158,72,86,83.6,80.0,86.87,BRGY. LONGOS
590,0465C,185,89,96,141,70,71,76.22,78.65,73.96,BRGY. LONGOS
591,0466A,189,77,112,138,52,86,73.02,67.53,76.79,BRGY. LONGOS
592,0466B,184,95,89,127,70,57,69.02,73.68,64.04,BRGY. LONGOS
593,0467A,186,86,100,121,52,69,65.05,60.47,69.0,BRGY. LONGOS
594,0467B,196,83,113,127,54,73,64.8,65.06,64.6,BRGY. LONGOS
595,0467C,193,92,101,31,19,12,16.06,20.65,11.88,BRGY. LONGOS
596,0468A,193,75,118,120,48,72,62.18,64.0,61.02,BRGY. LONGOS
597,0468B,198,89,109,145,66,79,73.23,74.16,72.48,BRGY. LONGOS
598,0468C,196,97,99,10,1,9,5.1,1.03,9.09,BRGY. LONGOS
599,0469A,195,81,114,123,52,71,63.08,64.2,62.28,BRGY. LONGOS
600,0469B,196,95,101,126,60,66,64.29,63.16,65.35,BRGY. LONGOS
601,0470A,190,92,98,129,60,69,67.89,65.22,70.41,BRGY. LONGOS
602,0470B,190,81,109,1,0,1,0.53,0.0,0.92,BRGY. LONGOS
603,0470C,186,79,107,0,0,0,0.0,0.0,0.0,BRGY. LONGOS
604,0470D,189,89,100,1,0,1,0.53,0.0,1.0,BRGY. LONGOS
605,0471A,189,86,103,152,70,82,80.42,81.4,79.61,BRGY. LONGOS
606,0471B,169,85,84,3,2,1,1.78,2.35,1.19,BRGY. LONGOS
607,0471C,178,87,91,4,2,2,2.25,2.3,2.2,BRGY. LONGOS
608,0472A,199,88,111,120,49,71,60.3,55.68,63.96,BRGY. LONGOS
609,0472B,199,107,92,3,2,1,1.51,1.87,1.09,BRGY. LONGOS
610,0473A,193,97,96,147,70,77,76.17,72.16,80.21,BRGY. LONGOS
611,0474A,189,96,93,170,83,87,89.95,86.46,93.55,BRGY. LONGOS
612,0474B,192,97,95,119,65,54,61.98,67.01,56.84,BRGY. LONGOS
613,0475A,193,93,100,154,77,77,79.79,82.8,77.0,BRGY. LONGOS
614,0475B,180,81,99,149,67,82,82.78,82.72,82.83,BRGY. LONGOS
615,0476A,189,85,104,132,61,71,69.84,71.76,68.27,BRGY. LONGOS
616,0477A,194,104,90,171,88,83,88.14,84.62,92.22,BRGY. LONGOS
617,0477B,194,97,97,105,52,53,54.12,53.61,54.64,BRGY. LONGOS
618,0477C,188,97,91,1,0,1,0.53,0.0,1.1,BRGY. LONGOS
619,0478A,195,81,114,155,61,94,79.49,75.31,82.46,BRGY. LONGOS
620,0478B,190,94,96,91,47,44,47.89,50.0,45.83,BRGY. LONGOS
621,0478C,197,105,92,4,0,4,2.03,0.0,4.35,BRGY. LONGOS
622,0479A,200,96,104,92,40,52,46.0,41.67,50.0,BRGY. LONGOS
623,0479B,199,93,106,0,0,0,0.0,0.0,0.0,BRGY. LONGOS
624,0479C,176,105,71,1,0,1,0.57,0.0,1.41,BRGY. LONGOS
625,0480A,194,84,110,114,47,67,58.76,55.95,60.91,BRGY. LONGOS
626,0481A,193,97,96,110,49,61,56.99,50.52,63.54,BRGY. LONGOS
627,0481B,179,82,97,123,56,67,68.72,68.29,69.07,BRGY. LONGOS
628,0482A,188,89,99,129,58,71,68.62,65.17,71.72,BRGY. LONGOS
629,0482B,163,82,81,14,9,5,8.59,10.98,6.17,BRGY. LONGOS
630,0483A,197,82,115,130,54,76,65.99,65.85,66.09,BRGY. LONGOS
631,0483B,198,97,101,23,10,13,11.62,10.31,12.87,BRGY. LONGOS
632,0484A,190,73,117,137,56,81,72.11,76.71,69.23,BRGY. LONGOS
633,0484B,191,79,112,135,55,80,70.68,69.62,71.43,BRGY. LONGOS
634,0484C,189,82,107,128,52,76,67.72,63.41,71.03,BRGY. LONGOS
635,0485A,191,85,106,134,54,80,70.16,63.53,75.47,BRGY. LONGOS
636,0485B,191,87,104,136,56,80,71.2,64.37,76.92,BRGY. LONGOS
637,0486A,189,82,107,112,47,65,59.26,57.32,60.75,BRGY. LONGOS
638,0486B,193,91,102,129,61,68,66.84,67.03,66.67,BRGY. LONGOS
639,0487A,190,82,108,130,53,77,68.42,64.63,71.3,BRGY. LONGOS
640,0487B,192,86,106,153,67,86,79.69,77.91,81.13,BRGY. LONGOS
641,0487C,190,89,101,112,49,63,58.95,55.06,62.38,BRGY. LONGOS
642,0488A,188,86,102,134,58,76,71.28,67.44,74.51,BRGY. LONGOS
643,0488B,193,97,96,141,63,78,73.06,64.95,81.25,BRGY. LONGOS
644,0488C,190,96,94,158,83,75,83.16,86.46,79.79,BRGY. LONGOS
645,0488D,192,88,104,41,17,24,21.35,19.32,23.08,BRGY. LONGOS
646,0338A,197,86,111,186,81,105,94.42,94.19,94.59,BRGY. MAYSILO
647,0338B,194,95,99,176,87,89,90.72,91.58,89.9,BRGY. MAYSILO
648,0338C,196,93,103,113,62,51,57.65,66.67,49.51,BRGY. MAYSILO
649,0338D,200,109,91,3,2,1,1.5,1.83,1.1,BRGY. MAYSILO
650,0339A,196,100,96,185,97,88,94.39,97.0,91.67,BRGY. MAYSILO
651,0339B,187,87,100,1,1,0,0.53,1.15,0.0,BRGY. MAYSILO
652,0340A,197,84,113,169,75,94,85.79,89.29,83.19,BRGY. MAYSILO
653,0340B,141,58,83,2,1,1,1.42,1.72,1.2,BRGY. MAYSILO
654,0341A,193,90,103,130,62,68,67.36,68.89,66.02,BRGY. MAYSILO
655,0342A,195,101,94,109,60,49,55.9,59.41,52.13,BRGY. MAYSILO
656,0343A,191,89,102,147,66,81,76.96,74.16,79.41,BRGY. MAYSILO
657,0344A,183,92,91,154,77,77,84.15,83.7,84.62,BRGY. MAYSILO
658,0345A,197,79,118,158,64,94,80.2,81.01,79.66,BRGY. MAYSILO
659,0345B,191,87,104,7,4,3,3.66,4.6,2.88,BRGY. MAYSILO
660,0346A,198,84,114,172,74,98,86.87,88.1,85.96,BRGY. MAYSILO
661,0347A,184,83,101,166,77,89,90.22,92.77,88.12,BRGY. MAYSILO
662,0348A,191,93,98,128,65,63,67.02,69.89,64.29,BRGY. MAYSILO
663,0349A,198,106,92,159,88,71,80.3,83.02,77.17,BRGY. MAYSILO
664,0350A,193,81,112,155,63,92,80.31,77.78,82.14,BRGY. MAYSILO
665,0350B,194,108,86,145,73,72,74.74,67.59,83.72,BRGY. MAYSILO
666,0351A,198,102,96,184,93,91,92.93,91.18,94.79,BRGY. MAYSILO
667,0351B,184,95,89,163,85,78,88.59,89.47,87.64,BRGY. MAYSILO
668,0352A,197,100,97,192,96,96,97.46,96.0,98.97,BRGY. MAYSILO
669,0352B,190,98,92,170,90,80,89.47,91.84,86.96,BRGY. MAYSILO
670,0352C,182,78,104,173,74,99,95.05,94.87,95.19,BRGY. MAYSILO
671,0353A,191,85,106,165,73,92,86.39,85.88,86.79,BRGY. MAYSILO
672,0353B,187,93,94,181,91,90,96.79,97.85,95.74,BRGY. MAYSILO
673,0354A,189,110,79,182,107,75,96.3,97.27,94.94,BRGY. MAYSILO
674,0355A,193,87,106,187,85,102,96.89,97.7,96.23,BRGY. MAYSILO
675,0356A,200,86,114,169,67,102,84.5,77.91,89.47,BRGY. MAYSILO
676,0356B,190,111,79,152,87,65,80.0,78.38,82.28,BRGY. MAYSILO
677,0356C,189,101,88,158,82,76,83.6,81.19,86.36,BRGY. MAYSILO
678,0357A,196,104,92,153,81,72,78.06,77.88,78.26,BRGY. MAYSILO
679,0358A,192,89,103,143,61,82,74.48,68.54,79.61,BRGY. MAYSILO
680,0358B,195,87,108,131,58,73,67.18,66.67,67.59,BRGY. MAYSILO
681,0359A,184,97,87,174,91,83,94.57,93.81,95.4,BRGY. MAYSILO
682,0359B,190,81,109,170,72,98,89.47,88.89,89.91,BRGY. MAYSILO
683,0360A,197,81,116,172,73,99,87.31,90.12,85.34,BRGY. MAYSILO
684,0360B,197,96,101,170,84,86,86.29,87.5,85.15,BRGY. MAYSILO
685,0360C,184,90,94,5,2,3,2.72,2.22,3.19,BRGY. MAYSILO
686,0360D,153,80,73,5,3,2,3.27,3.75,2.74,BRGY. MAYSILO
687,0185A,199,98,101,143,66,77,71.86,67.35,76.24,BRGY. MUZON
688,0185B,197,92,105,134,62,72,68.02,67.39,68.57,BRGY. MUZON
689,0186A,195,101,94,125,61,64,64.1,60.4,68.09,BRGY. MUZON
690,0186B,197,83,114,130,55,75,65.99,66.27,65.79,BRGY. MUZON
691,0187A,188,95,93,105,53,52,55.85,55.79,55.91,BRGY. MUZON
692,0187B,195,93,102,102,47,55,52.31,50.54,53.92,BRGY. MUZON
693,0188A,192,101,91,107,51,56,55.73,50.5,61.54,BRGY. MUZON
694,0188B,189,99,90,139,75,64,73.54,75.76,71.11,BRGY. MUZON
695,0189A,195,104,91,141,76,65,72.31,73.08,71.43,BRGY. MUZON
696,0189B,188,96,92,131,60,71,69.68,62.5,77.17,BRGY. MUZON
697,0190A,195,92,103,130,60,70,66.67,65.22,67.96,BRGY. MUZON
698,0190B,190,80,110,120,50,70,63.16,62.5,63.64,BRGY. MUZON
699,0191A,195,97,98,125,56,69,64.1,57.73,70.41,BRGY. MUZON
700,0191B,167,91,76,9,3,6,5.39,3.3,7.89,BRGY. MUZON
701,0192A,189,94,95,117,59,58,61.9,62.77,61.05,BRGY. MUZON
702,0193A,191,90,101,170,80,90,89.01,88.89,89.11,BRGY. MUZON
703,0193B,187,91,96,178,88,90,95.19,96.7,93.75,BRGY. MUZON
704,0194A,188,85,103,174,80,94,92.55,94.12,91.26,BRGY. MUZON
705,0194B,188,85,103,174,78,96,92.55,91.76,93.2,BRGY. MUZON
706,0194C,194,105,89,165,87,78,85.05,82.86,87.64,BRGY. MUZON
707,0195A,194,88,106,183,82,101,94.33,93.18,95.28,BRGY. MUZON
708,0196A,189,95,94,137,67,70,72.49,70.53,74.47,BRGY. MUZON
709,0197A,187,85,102,157,71,86,83.96,83.53,84.31,BRGY. MUZON
710,0198A,199,88,111,190,87,103,95.48,98.86,92.79,BRGY. MUZON
711,0199A,194,87,107,168,76,92,86.6,87.36,85.98,BRGY. MUZON
712,0199B,188,86,102,5,3,2,2.66,3.49,1.96,BRGY. MUZON
713,0199C,133,73,60,9,2,7,6.77,2.74,11.67,BRGY. MUZON
714,0361A,177,101,76,126,73,53,71.19,72.28,69.74,BRGY. NIUGAN
715,0361B,169,75,94,29,7,22,17.16,9.33,23.4,BRGY. NIUGAN
716,0362A,200,89,111,127,61,66,63.5,68.54,59.46,BRGY. NIUGAN
717,0362B,181,87,94,110,51,59,60.77,58.62,62.77,BRGY. NIUGAN
718,0363A,168,86,82,131,65,66,77.98,75.58,80.49,BRGY. NIUGAN
719,0363B,198,107,91,16,8,8,8.08,7.48,8.79,BRGY. NIUGAN
720,0364A,166,81,85,120,57,63,72.29,70.37,74.12,BRGY. NIUGAN
721,0365A,189,90,99,140,71,69,74.07,78.89,69.7,BRGY. NIUGAN
722,0365B,183,98,85,120,66,54,65.57,67.35,63.53,BRGY. NIUGAN
723,0366A,194,86,108,149,66,83,76.8,76.74,76.85,BRGY. NIUGAN
724,0366B,188,81,107,82,41,41,43.62,50.62,38.32,BRGY. NIUGAN
725,0367A,192,94,98,147,79,68,76.56,84.04,69.39,BRGY. NIUGAN
726,0368A,197,97,100,149,75,74,75.63,77.32,74.0,BRGY. NIUGAN
727,0369A,184,92,92,148,74,74,80.43,80.43,80.43,BRGY. NIUGAN
728,0370A,174,77,97,145,64,81,83.33,83.12,83.51,BRGY. NIUGAN
729,0370B,179,92,87,127,66,61,70.95,71.74,70.11,BRGY. NIUGAN
730,0371A,173,81,92,126,59,67,72.83,72.84,72.83,BRGY. NIUGAN
731,0371B,175,84,91,143,65,78,81.71,77.38,85.71,BRGY. NIUGAN
732,0372A,177,79,98,123,56,67,69.49,70.89,68.37,BRGY. NIUGAN
733,0373A,178,91,87,127,62,65,71.35,68.13,74.71,BRGY. NIUGAN
734,0373B,197,96,101,99,54,45,50.25,56.25,44.55,BRGY. NIUGAN
735,0374A,197,86,111,95,40,55,48.22,46.51,49.55,BRGY. NIUGAN
736,0374B,163,70,93,82,39,43,50.31,55.71,46.24,BRGY. NIUGAN
737,0375A,195,89,106,138,58,80,70.77,65.17,75.47,BRGY. NIUGAN
738,0375B,181,87,94,137,66,71,75.69,75.86,75.53,BRGY. NIUGAN
739,0255A,181,81,100,164,72,92,90.61,88.89,92.0,BRGY. PANGHULO
740,0255B,177,79,98,170,76,94,96.05,96.2,95.92,BRGY. PANGHULO
741,0256A,175,78,97,159,68,91,90.86,87.18,93.81,BRGY. PANGHULO
742,0256B,194,95,99,12,4,8,6.19,4.21,8.08,BRGY. PANGHULO
743,0257A,196,101,95,183,97,86,93.37,96.04,90.53,BRGY. PANGHULO
744,0257B,185,85,100,3,0,3,1.62,0.0,3.0,BRGY. PANGHULO
745,0257C,183,95,88,11,6,5,6.01,6.32,5.68,BRGY. PANGHULO
746,0258A,188,85,103,171,75,96,90.96,88.24,93.2,BRGY. PANGHULO
747,0258B,186,94,92,168,83,85,90.32,88.3,92.39,BRGY. PANGHULO
748,0258C,183,88,95,179,86,93,97.81,97.73,97.89,BRGY. PANGHULO
749,0259A,197,86,111,174,77,97,88.32,89.53,87.39,BRGY. PANGHULO
750,0259B,181,70,111,9,2,7,4.97,2.86,6.31,BRGY. PANGHULO
751,0260A,193,77,116,157,60,97,81.35,77.92,83.62,BRGY. PANGHULO
752,0260B,134,77,57,2,1,1,1.49,1.3,1.75,BRGY. PANGHULO
753,0261A,190,82,108,140,58,82,73.68,70.73,75.93,BRGY. PANGHULO
754,0261B,151,80,71,11,6,5,7.28,7.5,7.04,BRGY. PANGHULO
755,0262A,179,67,112,138,52,86,77.09,77.61,76.79,BRGY. PANGHULO
756,0262B,138,72,66,6,1,5,4.35,1.39,7.58,BRGY. PANGHULO
757,0263A,184,100,84,151,81,70,82.07,81.0,83.33,BRGY. PANGHULO
758,0264A,182,91,91,149,75,74,81.87,82.42,81.32,BRGY. PANGHULO
759,0265A,194,91,103,188,87,101,96.91,95.6,98.06,BRGY. PANGHULO
760,0266A,195,97,98,187,93,94,95.9,95.88,95.92,BRGY. PANGHULO
761,0267A,196,91,105,184,85,99,93.88,93.41,94.29,BRGY. PANGHULO
762,0267B,192,98,94,190,97,93,98.96,98.98,98.94,BRGY. PANGHULO
763,0268A,198,88,110,179,77,102,90.4,87.5,92.73,BRGY. PANGHULO
764,0269A,195,97,98,171,86,85,87.69,88.66,86.73,BRGY. PANGHULO
765,0269B,193,92,101,178,91,87,92.23,98.91,86.14,BRGY. PANGHULO
766,0270A,196,103,93,191,100,91,97.45,97.09,97.85,BRGY. PANGHULO
767,0270B,195,80,115,190,79,111,97.44,98.75,96.52,BRGY. PANGHULO
768,0271A,197,98,99,190,95,95,96.45,96.94,95.96,BRGY. PANGHULO
769,0271B,193,94,99,183,91,92,94.82,96.81,92.93,BRGY. PANGHULO
770,0271C,188,84,104,177,78,99,94.15,92.86,95.19,BRGY. PANGHULO
771,0271D,190,93,97,184,92,92,96.84,98.92,94.85,BRGY. PANGHULO
772,0272A,187,84,103,177,78,99,94.65,92.86,96.12,BRGY. PANGHULO
773,0272B,195,93,102,172,82,90,88.21,88.17,88.24,BRGY. PANGHULO
774,0272C,192,93,99,169,80,89,88.02,86.02,89.9,BRGY. PANGHULO
775,0272D,190,90,100,8,6,2,4.21,6.67,2.0,BRGY. PANGHULO
776,0273A,192,80,112,165,67,98,85.94,83.75,87.5,BRGY. PANGHULO
777,0274A,193,94,99,170,83,87,88.08,88.3,87.88,BRGY. PANGHULO
778,0275A,198,105,93,188,100,88,94.95,95.24,94.62,BRGY. PANGHULO
779,0275B,181,77,104,9,6,3,4.97,7.79,2.88,BRGY. PANGHULO
780,0276A,173,72,101,128,47,81,73.99,65.28,80.2,BRGY. PANGHULO
781,0276B,181,75,106,9,3,6,4.97,4.0,5.66,BRGY. PANGHULO
782,0277A,197,91,106,179,83,96,90.86,91.21,90.57,BRGY. PANGHULO
783,0277B,192,96,96,12,6,6,6.25,6.25,6.25,BRGY. PANGHULO
784,0278A,185,98,87,121,64,57,65.41,65.31,65.52,BRGY. PANGHULO
785,0278B,188,91,97,127,61,66,67.55,67.03,68.04,BRGY. PANGHULO
786,0279A,166,75,91,142,65,77,85.54,86.67,84.62,BRGY. PANGHULO
787,0280A,177,84,93,168,82,86,94.92,97.62,92.47,BRGY. PANGHULO
788,0281A,181,94,87,128,64,64,70.72,68.09,73.56,BRGY. PANGHULO
789,0281B,191,79,112,188,78,110,98.43,98.73,98.21,BRGY. PANGHULO
790,0282A,197,97,100,152,75,77,77.16,77.32,77.0,BRGY. PANGHULO
791,0283A,163,75,88,131,59,72,80.37,78.67,81.82,BRGY. PANGHULO
792,0283B,108,66,42,6,2,4,5.56,3.03,9.52,BRGY. PANGHULO
793,0284A,134,70,64,125,63,62,93.28,90.0,96.88,BRGY. PANGHULO
794,0284B,174,71,103,172,70,102,98.85,98.59,99.03,BRGY. PANGHULO
795,0285A,194,94,100,136,64,72,70.1,68.09,72.0,BRGY. PANGHULO
796,0285B,191,106,85,152,83,69,79.58,78.3,81.18,BRGY. PANGHULO
797,0285C,194,96,98,12,7,5,6.19,7.29,5.1,BRGY. PANGHULO
798,0285D,119,44,75,6,1,5,5.04,2.27,6.67,BRGY. PANGHULO
799,0625A,194,97,97,121,54,67,62.37,55.67,69.07,BRGY. POTRERO
800,0626A,182,87,95,132,57,75,72.53,65.52,78.95,BRGY. POTRERO
801,0626B,191,90,101,127,62,65,66.49,68.89,64.36,BRGY. POTRERO
802,0626C,187,90,97,156,76,80,83.42,84.44,82.47,BRGY. POTRERO
803,0627A,172,83,89,121,59,62,70.35,71.08,69.66,BRGY. POTRERO
804,0627B,177,86,91,120,58,62,67.8,67.44,68.13,BRGY. POTRERO
805,0628A,194,99,95,118,68,50,60.82,68.69,52.63,BRGY. POTRERO
806,0629A,200,89,111,128,53,75,64.0,59.55,67.57,BRGY. POTRERO
807,0630A,200,82,118,106,44,62,53.0,53.66,52.54,BRGY. POTRERO
808,0630B,180,70,110,1,0,1,0.56,0.0,0.91,BRGY. POTRERO
809,0630C,151,85,66,0,0,0,0.0,0.0,0.0,BRGY. POTRERO
810,0631A,185,74,111,133,54,79,71.89,72.97,71.17,BRGY. POTRERO
811,0631B,196,88,108,135,66,69,68.88,75.0,63.89,BRGY. POTRERO
812,0632A,199,68,131,182,64,118,91.46,94.12,90.08,BRGY. POTRERO
813,0633A,198,87,111,184,82,102,92.93,94.25,91.89,BRGY. POTRERO
814,0633B,190,104,86,165,91,74,86.84,87.5,86.05,BRGY. POTRERO
815,0633C,197,92,105,167,82,85,84.77,89.13,80.95,BRGY. POTRERO
816,0634A,194,97,97,171,87,84,88.14,89.69,86.6,BRGY. POTRERO
817,0634B,197,99,98,166,79,87,84.26,79.8,88.78,BRGY. POTRERO
818,0634C,192,101,91,177,95,82,92.19,94.06,90.11,BRGY. POTRERO
819,0634D,193,84,109,178,76,102,92.23,90.48,93.58,BRGY. POTRERO
820,0634E,192,89,103,170,79,91,88.54,88.76,88.35,BRGY. POTRERO
821,0635A,196,87,109,185,84,101,94.39,96.55,92.66,BRGY. POTRERO
822,0635B,197,97,100,190,94,96,96.45,96.91,96.0,BRGY. POTRERO
823,0636A,194,99,95,180,93,87,92.78,93.94,91.58,BRGY. POTRERO
824,0636B,199,85,114,144,64,80,72.36,75.29,70.18,BRGY. POTRERO
825,0637A,173,87,86,163,79,84,94.22,90.8,97.67,BRGY. POTRERO
826,0638A,177,98,79,151,83,68,85.31,84.69,86.08,BRGY. POTRERO
827,0639A,166,80,86,162,79,83,97.59,98.75,96.51,BRGY. POTRERO
828,0640A,162,77,85,155,73,82,95.68,94.81,96.47,BRGY. POTRERO
829,0641A,176,79,97,173,79,94,98.3,100.0,96.91,BRGY. POTRERO
830,0642A,200,103,97,145,77,68,72.5,74.76,70.1,BRGY. POTRERO
831,0642B,162,72,90,149,66,83,91.98,91.67,92.22,BRGY. POTRERO
832,0643A,169,78,91,141,63,78,83.43,80.77,85.71,BRGY. POTRERO
833,0644A,166,85,81,149,74,75,89.76,87.06,92.59,BRGY. POTRERO
834,0645A,168,81,87,158,78,80,94.05,96.3,91.95,BRGY. POTRERO
835,0646A,172,85,87,142,72,70,82.56,84.71,80.46,BRGY. POTRERO
836,0647A,187,90,97,151,74,77,80.75,82.22,79.38,BRGY. POTRERO
837,0648A,197,89,108,170,81,89,86.29,91.01,82.41,BRGY. POTRERO
838,0648B,185,92,93,180,90,90,97.3,97.83,96.77,BRGY. POTRERO
839,0649A,187,98,89,180,93,87,96.26,94.9,97.75,BRGY. POTRERO
840,0650A,183,79,104,172,72,100,93.99,91.14,96.15,BRGY. POTRERO
841,0651A,186,106,80,178,101,77,95.7,95.28,96.25,BRGY. POTRERO
842,0651B,172,77,95,146,68,78,84.88,88.31,82.11,BRGY. POTRERO
843,0652A,183,78,105,151,64,87,82.51,82.05,82.86,BRGY. POTRERO
844,0652B,176,83,93,161,73,88,91.48,87.95,94.62,BRGY. POTRERO
845,0652C,165,77,88,150,68,82,90.91,88.31,93.18,BRGY. POTRERO
846,0653A,168,78,90,156,74,82,92.86,94.87,91.11,BRGY. POTRERO
847,0654A,181,84,97,149,71,78,82.32,84.52,80.41,BRGY. POTRERO
848,0655A,184,72,112,179,68,111,97.28,94.44,99.11,BRGY. POTRERO
849,0656A,183,90,93,139,68,71,75.96,75.56,76.34,BRGY. POTRERO
850,0657A,198,85,113,133,51,82,67.17,60.0,72.57,BRGY. POTRERO
851,0658A,192,93,99,145,72,73,75.52,77.42,73.74,BRGY. POTRERO
852,0659A,186,84,102,155,71,84,83.33,84.52,82.35,BRGY. POTRERO
853,0659B,185,87,98,152,74,78,82.16,85.06,79.59,BRGY. POTRERO
854,0660A,193,94,99,159,76,83,82.38,80.85,83.84,BRGY. POTRERO
855,0661A,200,93,107,158,71,87,79.0,76.34,81.31,BRGY. POTRERO
856,0661B,182,81,101,148,64,84,81.32,79.01,83.17,BRGY. POTRERO
857,0662A,168,86,82,143,71,72,85.12,82.56,87.8,BRGY. POTRERO
858,0662B,200,100,100,155,76,79,77.5,76.0,79.0,BRGY. POTRERO
859,0663A,181,74,107,165,65,100,91.16,87.84,93.46,BRGY. POTRERO
860,0663B,161,69,92,142,61,81,88.2,88.41,88.04,BRGY. POTRERO
861,0664A,168,85,83,132,72,60,78.57,84.71,72.29,BRGY. POTRERO
862,0664B,172,95,77,134,75,59,77.91,78.95,76.62,BRGY. POTRERO
863,0665A,178,91,87,166,83,83,93.26,91.21,95.4,BRGY. POTRERO
864,0666A,170,71,99,159,66,93,93.53,92.96,93.94,BRGY. POTRERO
865,0666B,163,80,83,132,69,63,80.98,86.25,75.9,BRGY. POTRERO
866,0667A,190,98,92,178,91,87,93.68,92.86,94.57,BRGY. POTRERO
867,0668A,183,74,109,110,50,60,60.11,67.57,55.05,BRGY. POTRERO
868,0669A,170,69,101,137,56,81,80.59,81.16,80.2,BRGY. POTRERO
869,0670A,175,78,97,145,66,79,82.86,84.62,81.44,BRGY. POTRERO
870,0671A,188,88,100,175,86,89,93.09,97.73,89.0,BRGY. POTRERO
871,0671B,188,94,94,135,66,69,71.81,70.21,73.4,BRGY. POTRERO
872,0672A,164,69,95,128,51,77,78.05,73.91,81.05,BRGY. POTRERO
873,0673A,181,87,94,132,60,72,72.93,68.97,76.6,BRGY. POTRERO
874,0673B,199,101,98,105,49,56,52.76,48.51,57.14,BRGY. POTRERO
875,0674A,191,81,110,186,79,107,97.38,97.53,97.27,BRGY. POTRERO
876,0674B,183,79,104,139,57,82,75.96,72.15,78.85,BRGY. POTRERO
877,0674C,190,92,98,157,78,79,82.63,84.78,80.61,BRGY. POTRERO
878,0675A,186,80,106,178,75,103,95.7,93.75,97.17,BRGY. POTRERO
879,0675B,181,98,83,157,86,71,86.74,87.76,85.54,BRGY. POTRERO
880,0676A,193,83,110,179,79,100,92.75,95.18,90.91,BRGY. POTRERO
881,0676B,162,68,94,78,33,45,48.15,48.53,47.87,BRGY. POTRERO
882,0677A,178,88,89,149,77,71,83.71,87.5,79.78,BRGY. POTRERO
883,0678A,165,83,82,145,71,74,87.88,85.54,90.24,BRGY. POTRERO
884,0679A,175,82,93,127,61,66,72.57,74.39,70.97,BRGY. POTRERO
885,0680A,158,69,89,128,62,66,81.01,89.86,74.16,BRGY. POTRERO
886,0680B,163,88,75,124,60,64,76.07,68.18,85.33,BRGY. POTRERO
887,0681A,190,80,110,141,57,84,74.21,71.25,76.36,BRGY. POTRERO
888,0681B,151,78,73,67,32,35,44.37,41.03,47.95,BRGY. POTRERO
889,0682A,160,76,84,143,67,76,89.38,88.16,90.48,BRGY. POTRERO
890,0682B,145,68,77,134,62,72,92.41,91.18,93.51,BRGY. POTRERO
891,0683A,200,96,104,117,52,65,58.5,54.17,62.5,BRGY. POTRERO
892,0683B,141,69,72,128,64,64,90.78,92.75,88.89,BRGY. POTRERO
893,0684A,150,73,77,91,44,47,60.67,60.27,61.04,BRGY. POTRERO
894,0685A,199,92,107,116,56,60,58.29,60.87,56.07,BRGY. POTRERO
895,0685B,178,94,84,0,0,0,0.0,0.0,0.0,BRGY. POTRERO
896,0685C,170,96,74,1,0,1,0.59,0.0,1.35,BRGY. POTRERO
897,0686A,159,77,82,105,52,53,66.04,67.53,64.63,BRGY. POTRERO
898,0686B,143,73,70,110,59,51,76.92,80.82,72.86,BRGY. POTRERO
899,0687A,190,81,109,111,42,69,58.42,51.85,63.3,BRGY. POTRERO
900,0687B,145,66,79,93,41,52,64.14,62.12,65.82,BRGY. POTRERO
901,0688A,197,87,110,92,47,45,46.7,54.02,40.91,BRGY. POTRERO
902,0689A,169,91,78,65,36,29,38.46,39.56,37.18,BRGY. POTRERO
903,0690A,193,83,110,164,66,98,84.97,79.52,89.09,BRGY. POTRERO
904,0690B,195,95,100,1,1,0,0.51,1.05,0.0,BRGY. POTRERO
905,0691A,200,91,109,177,78,99,88.5,85.71,90.83,BRGY. POTRERO
906,0691B,194,94,100,175,84,91,90.21,89.36,91.0,BRGY. POTRERO
907,0692A,194,90,104,186,86,100,95.88,95.56,96.15,BRGY. POTRERO
908,0692B,197,93,104,186,90,96,94.42,96.77,92.31,BRGY. POTRERO
909,0692C,197,90,107,178,81,97,90.36,90.0,90.65,BRGY. POTRERO
910,0693A,195,100,95,178,93,85,91.28,93.0,89.47,BRGY. POTRERO
911,0694A,195,88,107,183,83,100,93.85,94.32,93.46,BRGY. POTRERO
912,0695A,199,88,111,183,80,103,91.96,90.91,92.79,BRGY. POTRERO
913,0696A,169,84,85,78,35,43,46.15,41.67,50.59,BRGY. POTRERO
914,0697A,200,103,97,67,33,34,33.5,32.04,35.05,BRGY. POTRERO
915,0698A,144,72,72,81,38,43,56.25,52.78,59.72,BRGY. POTRERO
916,0699A,200,94,106,83,43,40,41.5,45.74,37.74,BRGY. POTRERO
917,0700A,200,94,106,118,65,53,59.0,69.15,50.0,BRGY. POTRERO
918,0701A,200,90,110,104,43,61,52.0,47.78,55.45,BRGY. POTRERO
919,0702A,183,81,102,110,50,60,60.11,61.73,58.82,BRGY. POTRERO
920,0703A,156,73,83,101,44,57,64.74,60.27,68.67,BRGY. POTRERO
921,0704A,160,82,78,99,52,47,61.88,63.41,60.26,BRGY. POTRERO
922,0705A,176,91,85,159,85,74,90.34,93.41,87.06,BRGY. POTRERO
923,0706A,183,89,94,180,89,91,98.36,100.0,96.81,BRGY. POTRERO
924,0707A,176,79,97,142,64,78,80.68,81.01,80.41,BRGY. POTRERO
925,0708A,167,83,84,144,72,72,86.23,86.75,85.71,BRGY. POTRERO
926,0709A,183,86,97,165,77,88,90.16,89.53,90.72,BRGY. POTRERO
927,0709B,155,77,78,152,76,76,98.06,98.7,97.44,BRGY. POTRERO
928,0710A,194,92,102,105,50,55,54.12,54.35,53.92,BRGY. POTRERO
929,0710B,194,94,100,83,38,45,42.78,40.43,45.0,BRGY. POTRERO
930,0711A,200,85,115,79,29,50,39.5,34.12,43.48,BRGY. POTRERO
931,0712A,200,100,99,67,30,36,33.5,30.0,36.36,BRGY. POTRERO
932,0713A,191,91,100,73,39,34,38.22,42.86,34.0,BRGY. POTRERO
933,0713B,194,75,119,68,32,36,35.05,42.67,30.25,BRGY. POTRERO
934,0714A,187,90,97,88,48,40,47.06,53.33,41.24,BRGY. POTRERO
935,0714B,151,83,68,103,58,45,68.21,69.88,66.18,BRGY. POTRERO
936,0715A,191,83,108,173,71,102,90.58,85.54,94.44,BRGY. POTRERO
937,0715B,178,81,97,171,78,93,96.07,96.3,95.88,BRGY. POTRERO
938,0716A,178,79,99,159,69,90,89.33,87.34,90.91,BRGY. POTRERO
939,0716B,149,67,82,139,63,76,93.29,94.03,92.68,BRGY. POTRERO
940,0717A,182,78,104,160,67,93,87.91,85.9,89.42,BRGY. POTRERO
941,0718A,191,91,100,187,88,99,97.91,96.7,99.0,BRGY. POTRERO
942,0718B,170,78,92,153,71,82,90.0,91.03,89.13,BRGY. POTRERO
943,0719A,173,73,100,160,70,90,92.49,95.89,90.0,BRGY. POTRERO
944,0720A,195,75,120,179,66,113,91.79,88.0,94.17,BRGY. POTRERO
945,0720B,146,57,89,65,24,41,44.52,42.11,46.07,BRGY. POTRERO
946,0721A,189,90,99,153,79,74,80.95,87.78,74.75,BRGY. POTRERO
947,0721B,166,71,95,161,69,92,96.99,97.18,96.84,BRGY. POTRERO
948,0722A,192,98,94,138,75,63,71.88,76.53,67.02,BRGY. POTRERO
949,0722B,191,89,102,55,24,31,28.8,26.97,30.39,BRGY. POTRERO
950,0723A,154,84,70,132,70,62,85.71,83.33,88.57,BRGY. POTRERO
951,0723B,141,62,79,131,57,74,92.91,91.94,93.67,BRGY. POTRERO
952,0724A,163,74,89,128,58,70,78.53,78.38,78.65,BRGY. POTRERO
953,0724B,137,70,67,89,51,38,64.96,72.86,56.72,BRGY. POTRERO
954,0725A,123,60,63,101,51,50,82.11,85.0,79.37,BRGY. POTRERO
955,0726A,153,73,80,95,49,46,62.09,67.12,57.5,BRGY. POTRERO
956,0726B,130,69,61,107,57,50,82.31,82.61,81.97,BRGY. POTRERO
957,0727A,146,55,91,131,49,82,89.73,89.09,90.11,BRGY. POTRERO
958,0728A,136,77,59,123,67,56,90.44,87.01,94.92,BRGY. POTRERO
959,0728B,147,73,74,109,47,62,74.15,64.38,83.78,BRGY. POTRERO
960,0729A,149,73,76,105,44,61,70.47,60.27,80.26,BRGY. POTRERO
961,0729B,147,65,82,107,55,52,72.79,84.62,63.41,BRGY. POTRERO
962,0730A,154,68,86,134,61,73,87.01,89.71,84.88,BRGY. POTRERO
963,0731A,161,79,82,134,65,69,83.23,82.28,84.15,BRGY. POTRERO
964,0001A,192,88,104,183,81,102,95.31,92.05,98.08,BRGY. SAN AGUSTIN
965,0001B,184,87,97,177,85,92,96.2,97.7,94.85,BRGY. SAN AGUSTIN
966,0002A,194,89,105,156,69,87,80.41,77.53,82.86,BRGY. SAN AGUSTIN
967,0002B,189,102,87,170,91,79,89.95,89.22,90.8,BRGY. SAN AGUSTIN
968,0003A,195,87,108,158,76,82,81.03,87.36,75.93,BRGY. SAN AGUSTIN
969,0003B,188,96,92,176,91,85,93.62,94.79,92.39,BRGY. SAN AGUSTIN
970,0004A,184,89,95,166,81,85,90.22,91.01,89.47,BRGY. SAN AGUSTIN
971,0004B,185,77,108,168,68,100,90.81,88.31,92.59,BRGY. SAN AGUSTIN
972,0005A,195,99,95,189,96,92,96.92,96.97,96.84,BRGY. SAN AGUSTIN
973,0005B,193,95,98,166,85,81,86.01,89.47,82.65,BRGY. SAN AGUSTIN
974,0006A,197,95,102,167,82,85,84.77,86.32,83.33,BRGY. SAN AGUSTIN
975,0006B,200,104,96,8,5,3,4.0,4.81,3.13,BRGY. SAN AGUSTIN
976,0007A,194,94,100,157,75,82,80.93,79.79,82.0,BRGY. SAN AGUSTIN
977,0008A,194,83,111,143,61,82,73.71,73.49,73.87,BRGY. SAN AGUSTIN
978,0009A,193,81,112,154,63,91,79.79,77.78,81.25,BRGY. SAN AGUSTIN
979,0010A,195,96,99,143,73,70,73.33,76.04,70.71,BRGY. SAN AGUSTIN
980,0011A,187,83,104,137,59,78,73.26,71.08,75.0,BRGY. SAN AGUSTIN
981,0012A,198,88,110,170,80,90,85.86,90.91,81.82,BRGY. SAN AGUSTIN
982,0012B,185,87,98,171,83,88,92.43,95.4,89.8,BRGY. SAN AGUSTIN
983,0012C,186,91,95,133,61,72,71.51,67.03,75.79,BRGY. SAN AGUSTIN
984,0013A,193,93,100,143,66,77,74.09,70.97,77.0,BRGY. SAN AGUSTIN
985,0013B,186,93,93,175,86,89,94.09,92.47,95.7,BRGY. SAN AGUSTIN
986,0014A,188,86,102,163,81,82,86.7,94.19,80.39,BRGY. SAN AGUSTIN
987,0014B,196,101,95,2,0,2,1.02,0.0,2.11,BRGY. SAN AGUSTIN
988,0015A,190,92,98,169,81,88,88.95,88.04,89.8,BRGY. SAN AGUSTIN
989,0015B,185,93,92,169,84,85,91.35,90.32,92.39,BRGY. SAN AGUSTIN
990,0016A,193,97,96,184,92,92,95.34,94.85,95.83,BRGY. SAN AGUSTIN
991,0016B,191,96,95,183,95,88,95.81,98.96,92.63,BRGY. SAN AGUSTIN
992,0016C,195,103,92,195,103,92,100.0,100.0,100.0,BRGY. SAN AGUSTIN
993,0017A,187,82,105,173,75,98,92.51,91.46,93.33,BRGY. SAN AGUSTIN
994,0018A,193,95,98,165,82,83,85.49,86.32,84.69,BRGY. SAN AGUSTIN
995,0018B,190,73,117,163,64,99,85.79,87.67,84.62,BRGY. SAN AGUSTIN
996,0019A,189,85,104,172,77,95,91.01,90.59,91.35,BRGY. SAN AGUSTIN
997,0020A,195,88,107,182,83,99,93.33,94.32,92.52,BRGY. SAN AGUSTIN
998,0021A,195,98,97,170,82,88,87.18,83.67,90.72,BRGY. SAN AGUSTIN
999,0022A,191,99,92,174,89,85,91.1,89.9,92.39,BRGY. SAN AGUSTIN
1000,0022B,190,92,98,174,84,90,91.58,91.3,91.84,BRGY. SAN AGUSTIN
1001,0023A,196,97,99,141,66,75,71.94,68.04,75.76,BRGY. SAN AGUSTIN
1002,0023B,192,96,96,132,64,68,68.75,66.67,70.83,BRGY. SAN AGUSTIN
1003,0024A,193,99,94,185,93,92,95.85,93.94,97.87,BRGY. SAN AGUSTIN
1004,0024B,194,99,95,11,3,8,5.67,3.03,8.42,BRGY. SAN AGUSTIN
1005,0025A,193,108,85,116,58,58,60.1,53.7,68.24,BRGY. SAN AGUSTIN
1006,0026A,180,103,77,135,74,61,75.0,71.84,79.22,BRGY. SAN AGUSTIN
1007,0027A,184,78,106,119,56,63,64.67,71.79,59.43,BRGY. SAN AGUSTIN
1008,0028A,188,81,107,117,54,63,62.23,66.67,58.88,BRGY. SAN AGUSTIN
1009,0029A,192,85,107,179,78,101,93.23,91.76,94.39,BRGY. SAN AGUSTIN
1010,0030A,194,84,110,173,75,98,89.18,89.29,89.09,BRGY. SAN AGUSTIN
1011,0030B,138,69,69,7,1,6,5.07,1.45,8.7,BRGY. SAN AGUSTIN
1012,0031A,192,95,97,159,80,79,82.81,84.21,81.44,BRGY. SAN AGUSTIN
1013,0031B,194,90,104,10,4,6,5.15,4.44,5.77,BRGY. SAN AGUSTIN
1014,0286A,192,97,95,181,90,91,94.27,92.78,95.79,BRGY. SANTOLAN
1015,0286B,183,96,87,163,85,78,89.07,88.54,89.66,BRGY. SANTOLAN
1016,0287A,191,97,94,173,88,85,90.58,90.72,90.43,BRGY. SANTOLAN
1017,0287B,194,87,107,183,84,99,94.33,96.55,92.52,BRGY. SANTOLAN
1018,0288A,184,82,102,168,77,91,91.3,93.9,89.22,BRGY. SANTOLAN
1019,0288B,189,113,76,0,0,0,0.0,0.0,0.0,BRGY. SANTOLAN
1020,0289A,196,85,111,183,79,104,93.37,92.94,93.69,BRGY. SANTOLAN
1021,0289B,191,94,97,0,0,0,0.0,0.0,0.0,BRGY. SANTOLAN
1022,0289C,157,85,72,6,5,1,3.82,5.88,1.39,BRGY. SANTOLAN
1023,0290A,187,94,93,182,92,90,97.33,97.87,96.77,BRGY. SANTOLAN
1024,0290B,189,93,96,178,88,90,94.18,94.62,93.75,BRGY. SANTOLAN
1025,0290C,189,86,103,167,76,91,88.36,88.37,88.35,BRGY. SANTOLAN
1026,0291A,197,89,108,176,80,96,89.34,89.89,88.89,BRGY. SANTOLAN
1027,0291B,200,91,109,180,81,99,90.0,89.01,90.83,BRGY. SANTOLAN
1028,0292A,194,82,112,167,67,100,86.08,81.71,89.29,BRGY. SANTOLAN
1029,0292B,200,100,100,2,1,1,1.0,1.0,1.0,BRGY. SANTOLAN
1030,0293A,183,84,99,165,75,90,90.16,89.29,90.91,BRGY. SANTOLAN
1031,0293B,197,94,103,8,3,5,4.06,3.19,4.85,BRGY. SANTOLAN
1032,0294A,184,95,89,170,91,79,92.39,95.79,88.76,BRGY. SANTOLAN
1033,0295A,181,79,102,174,73,101,96.13,92.41,99.02,BRGY. SANTOLAN
1034,0295B,170,73,97,137,58,79,80.59,79.45,81.44,BRGY. SANTOLAN
1035,0296A,173,80,93,129,62,67,74.57,77.5,72.04,BRGY. SANTOLAN
1036,0297A,185,91,94,146,73,73,78.92,80.22,77.66,BRGY. SANTOLAN
1037,0298A,189,90,99,173,85,88,91.53,94.44,88.89,BRGY. SANTOLAN
1038,0298B,199,84,115,174,73,101,87.44,86.9,87.83,BRGY. SANTOLAN
1039,0298C,135,68,67,16,5,11,11.85,7.35,16.42,BRGY. SANTOLAN
1040,0298D,128,61,67,2,1,1,1.56,1.64,1.49,BRGY. SANTOLAN
1041,0299A,195,105,90,159,83,76,81.54,79.05,84.44,BRGY. SANTOLAN
1042,0299B,166,76,90,138,63,75,83.13,82.89,83.33,BRGY. SANTOLAN
1043,0300A,187,87,100,160,72,88,85.56,82.76,88.0,BRGY. SANTOLAN
1044,0300B,182,87,95,157,75,82,86.26,86.21,86.32,BRGY. SANTOLAN
1045,0301A,190,88,102,168,77,91,88.42,87.5,89.22,BRGY. SANTOLAN
1046,0301B,182,81,101,155,69,86,85.16,85.19,85.15,BRGY. SANTOLAN
1047,0301C,182,87,95,159,76,83,87.36,87.36,87.37,BRGY. SANTOLAN
1048,0301D,187,84,103,185,83,102,98.93,98.81,99.03,BRGY. SANTOLAN
1049,0302A,189,88,101,184,86,98,97.35,97.73,97.03,BRGY. SANTOLAN
1050,0303A,200,95,105,184,87,97,92.0,91.58,92.38,BRGY. SANTOLAN
1051,0304A,196,96,100,185,91,94,94.39,94.79,94.0,BRGY. SANTOLAN
1052,0304B,196,97,99,147,74,73,75.0,76.29,73.74,BRGY. SANTOLAN
1053,0304C,188,82,106,3,2,1,1.6,2.44,0.94,BRGY. SANTOLAN
1054,0304D,157,89,68,7,5,2,4.46,5.62,2.94,BRGY. SANTOLAN
1055,0305A,199,96,103,137,69,68,68.84,71.88,66.02,BRGY. SANTOLAN
1056,0306A,196,104,92,187,98,89,95.41,94.23,96.74,BRGY. SANTOLAN
1057,0307A,187,85,102,181,82,99,96.79,96.47,97.06,BRGY. SANTOLAN
1058,0308A,184,76,108,172,74,98,93.48,97.37,90.74,BRGY. SANTOLAN
1059,0309A,193,103,90,171,95,76,88.6,92.23,84.44,BRGY. SANTOLAN
1060,0310A,190,77,113,158,66,92,83.16,85.71,81.42,BRGY. SANTOLAN
1061,0310B,190,100,90,162,83,79,85.26,83.0,87.78,BRGY. SANTOLAN
1062,0311A,191,81,110,159,71,88,83.25,87.65,80.0,BRGY. SANTOLAN
1063,0311B,194,89,105,163,75,88,84.02,84.27,83.81,BRGY. SANTOLAN
1064,0311C,194,88,106,176,79,97,90.72,89.77,91.51,BRGY. SANTOLAN
1065,0311D,192,83,109,7,3,4,3.65,3.61,3.67,BRGY. SANTOLAN
1066,0032A,192,90,102,95,41,54,49.48,45.56,52.94,BRGY. TAñONG
1067,0033A,186,88,98,96,45,51,51.61,51.14,52.04,BRGY. TAñONG
1068,0034A,180,87,93,134,60,74,74.44,68.97,79.57,BRGY. TAñONG
1069,0035A,165,85,80,115,63,52,69.7,74.12,65.0,BRGY. TAñONG
1070,0035B,158,71,87,142,65,77,89.87,91.55,88.51,BRGY. TAñONG
1071,0036A,184,80,104,112,49,63,60.87,61.25,60.58,BRGY. TAñONG
1072,0037A,187,92,95,125,57,68,66.84,61.96,71.58,BRGY. TAñONG
1073,0037B,183,88,95,110,53,57,60.11,60.23,60.0,BRGY. TAñONG
1074,0037C,200,103,97,108,50,58,54.0,48.54,59.79,BRGY. TAñONG
1075,0038A,172,75,97,133,55,78,77.33,73.33,80.41,BRGY. TAñONG
1076,0038B,182,89,93,142,70,72,78.02,78.65,77.42,BRGY. TAñONG
1077,0039A,192,79,113,138,57,81,71.88,72.15,71.68,BRGY. TAñONG
1078,0039B,166,77,89,115,55,60,69.28,71.43,67.42,BRGY. TAñONG
1079,0040A,173,73,100,134,57,77,77.46,78.08,77.0,BRGY. TAñONG
1080,0041A,189,94,95,147,74,73,77.78,78.72,76.84,BRGY. TAñONG
1081,0041B,196,95,101,4,1,3,2.04,1.05,2.97,BRGY. TAñONG
1082,0042A,181,74,107,113,38,75,62.43,51.35,70.09,BRGY. TAñONG
1083,0042B,187,94,93,180,91,89,96.26,96.81,95.7,BRGY. TAñONG
1084,0043A,178,82,96,133,63,70,74.72,76.83,72.92,BRGY. TAñONG
1085,0043B,196,93,103,101,48,53,51.53,51.61,51.46,BRGY. TAñONG
1086,0044A,179,79,100,144,63,81,80.45,79.75,81.0,BRGY. TAñONG
1087,0044B,187,90,97,156,73,83,83.42,81.11,85.57,BRGY. TAñONG
1088,0045A,194,86,108,157,68,89,80.93,79.07,82.41,BRGY. TAñONG
1089,0045B,185,88,97,135,64,71,72.97,72.73,73.2,BRGY. TAñONG
1090,0046A,196,92,104,124,55,69,63.27,59.78,66.35,BRGY. TAñONG
1091,0046B,196,76,120,130,49,81,66.33,64.47,67.5,BRGY. TAñONG
1092,0046C,178,93,85,2,2,0,1.12,2.15,0.0,BRGY. TAñONG
1093,0047A,195,88,107,122,52,70,62.56,59.09,65.42,BRGY. TAñONG
1094,0047B,180,75,105,128,58,70,71.11,77.33,66.67,BRGY. TAñONG
1095,0048A,195,92,103,134,60,74,68.72,65.22,71.84,BRGY. TAñONG
1096,0048B,189,97,92,126,59,67,66.67,60.82,72.83,BRGY. TAñONG
1097,0049A,181,87,94,119,55,64,65.75,63.22,68.09,BRGY. TAñONG
1098,0050A,198,84,114,126,50,76,63.64,59.52,66.67,BRGY. TAñONG
1099,0051A,186,89,97,118,55,63,63.44,61.8,64.95,BRGY. TAñONG
1100,0052A,182,85,97,138,61,77,75.82,71.76,79.38,BRGY. TAñONG
1101,0053A,199,92,107,154,72,82,77.39,78.26,76.64,BRGY. TAñONG
1102,0054A,196,82,114,153,61,92,78.06,74.39,80.7,BRGY. TAñONG
1103,0055A,183,89,94,132,64,68,72.13,71.91,72.34,BRGY. TAñONG
1104,0055B,194,103,91,140,71,69,72.16,68.93,75.82,BRGY. TAñONG
1105,0056A,192,90,102,135,60,75,70.31,66.67,73.53,BRGY. TAñONG
1106,0057A,191,82,109,149,61,88,78.01,74.39,80.73,BRGY. TAñONG
1107,0058A,185,89,96,134,68,66,72.43,76.4,68.75,BRGY. TAñONG
1108,0059A,189,91,98,123,62,61,65.08,68.13,62.24,BRGY. TAñONG
1109,0059B,173,84,89,102,51,51,58.96,60.71,57.3,BRGY. TAñONG
1110,0060A,188,77,111,124,51,73,65.96,66.23,65.77,BRGY. TAñONG
1111,0060B,178,90,88,3,1,2,1.69,1.11,2.27,BRGY. TAñONG
1112,0061A,180,102,78,138,81,57,76.67,79.41,73.08,BRGY. TAñONG
1113,0061B,174,89,85,122,67,55,70.11,75.28,64.71,BRGY. TAñONG
1114,0062A,178,79,99,121,56,65,67.98,70.89,65.66,BRGY. TAñONG
1115,0063A,180,76,104,116,46,70,64.44,60.53,67.31,BRGY. TAñONG
1116,0063B,150,67,83,0,0,0,0.0,0.0,0.0,BRGY. TAñONG
1117,0064A,167,76,91,136,61,75,81.44,80.26,82.42,BRGY. TAñONG
1118,0065A,177,70,107,123,49,74,69.49,70.0,69.16,BRGY. TAñONG
1119,0066A,183,81,102,128,57,71,69.95,70.37,69.61,BRGY. TAñONG
1120,0067A,165,71,94,111,47,64,67.27,66.2,68.09,BRGY. TAñONG
1121,0575A,197,77,120,158,67,91,80.2,87.01,75.83,BRGY. TINAJEROS
1122,0575B,191,88,103,147,70,77,76.96,79.55,74.76,BRGY. TINAJEROS
1123,0575C,195,91,104,136,62,74,69.74,68.13,71.15,BRGY. TINAJEROS
1124,0576A,199,90,109,155,74,81,77.89,82.22,74.31,BRGY. TINAJEROS
1125,0576B,189,97,92,147,77,70,77.78,79.38,76.09,BRGY. TINAJEROS
1126,0576C,183,87,96,129,64,65,70.49,73.56,67.71,BRGY. TINAJEROS
1127,0577A,187,103,84,133,78,55,71.12,75.73,65.48,BRGY. TINAJEROS
1128,0577B,180,78,102,120,53,67,66.67,67.95,65.69,BRGY. TINAJEROS
1129,0578A,186,79,107,154,63,91,82.8,79.75,85.05,BRGY. TINAJEROS
1130,0578B,186,80,106,130,53,77,69.89,66.25,72.64,BRGY. TINAJEROS
1131,0578C,180,73,107,126,46,80,70.0,63.01,74.77,BRGY. TINAJEROS
1132,0579A,184,78,106,121,57,64,65.76,73.08,60.38,BRGY. TINAJEROS
1133,0579B,192,86,106,128,51,77,66.67,59.3,72.64,BRGY. TINAJEROS
1134,0580A,173,76,97,96,43,53,55.49,56.58,54.64,BRGY. TINAJEROS
1135,0580B,196,88,108,123,55,68,62.76,62.5,62.96,BRGY. TINAJEROS
1136,0581A,178,80,98,117,57,60,65.73,71.25,61.22,BRGY. TINAJEROS
1137,0581B,195,90,105,121,47,74,62.05,52.22,70.48,BRGY. TINAJEROS
1138,0582A,193,83,110,111,47,64,57.51,56.63,58.18,BRGY. TINAJEROS
1139,0582B,197,90,107,140,61,79,71.07,67.78,73.83,BRGY. TINAJEROS
1140,0582C,182,86,96,119,51,68,65.38,59.3,70.83,BRGY. TINAJEROS
1141,0583A,172,87,85,111,54,57,64.53,62.07,67.06,BRGY. TINAJEROS
1142,0583B,173,78,95,125,56,69,72.25,71.79,72.63,BRGY. TINAJEROS
1143,0584A,179,88,91,113,56,57,63.13,63.64,62.64,BRGY. TINAJEROS
1144,0584B,190,99,91,110,60,50,57.89,60.61,54.95,BRGY. TINAJEROS
1145,0585A,189,79,110,132,47,85,69.84,59.49,77.27,BRGY. TINAJEROS
1146,0586A,182,79,103,121,56,65,66.48,70.89,63.11,BRGY. TINAJEROS
1147,0587A,184,85,99,128,59,69,69.57,69.41,69.7,BRGY. TINAJEROS
1148,0588A,185,88,97,145,66,79,78.38,75.0,81.44,BRGY. TINAJEROS
1149,0589A,200,105,95,119,66,53,59.5,62.86,55.79,BRGY. TINAJEROS
1150,0589B,192,99,93,107,59,48,55.73,59.6,51.61,BRGY. TINAJEROS
1151,0590A,188,87,101,146,67,79,77.66,77.01,78.22,BRGY. TINAJEROS
1152,0590B,194,123,71,8,4,4,4.12,3.25,5.63,BRGY. TINAJEROS
1153,0591A,194,90,104,135,62,73,69.59,68.89,70.19,BRGY. TINAJEROS
1154,0591B,194,88,106,132,60,72,68.04,68.18,67.92,BRGY. TINAJEROS
1155,0591C,184,87,97,125,58,67,67.93,66.67,69.07,BRGY. TINAJEROS
1156,0592A,187,86,101,127,64,63,67.91,74.42,62.38,BRGY. TINAJEROS
1157,0592B,196,103,93,5,3,2,2.55,2.91,2.15,BRGY. TINAJEROS
1158,0593A,200,91,109,114,51,63,57.0,56.04,57.8,BRGY. TINAJEROS
1159,0593B,199,101,98,4,3,1,2.01,2.97,1.02,BRGY. TINAJEROS
1160,0594A,195,82,113,119,46,73,61.03,56.1,64.6,BRGY. TINAJEROS
1161,0595A,179,84,95,96,47,49,53.63,55.95,51.58,BRGY. TINAJEROS
1162,0595B,179,73,106,105,42,63,58.66,57.53,59.43,BRGY. TINAJEROS
1163,0596A,197,87,110,189,85,104,95.94,97.7,94.55,BRGY. TINAJEROS
1164,0597A,194,90,104,185,88,97,95.36,97.78,93.27,BRGY. TINAJEROS
1165,0598A,199,83,116,152,62,90,76.38,74.7,77.59,BRGY. TINAJEROS
1166,0598B,200,81,119,45,12,33,22.5,14.81,27.73,BRGY. TINAJEROS
1167,0599A,182,89,93,160,73,87,87.91,82.02,93.55,BRGY. TINAJEROS
1168,0600A,195,101,94,190,96,94,97.44,95.05,100.0,BRGY. TINAJEROS
1169,0600B,139,70,69,109,59,50,78.42,84.29,72.46,BRGY. TINAJEROS
1170,0601A,196,82,114,156,65,91,79.59,79.27,79.82,BRGY. TINAJEROS
1171,0602A,200,97,103,191,91,100,95.5,93.81,97.09,BRGY. TINAJEROS
1172,0602B,199,99,100,68,30,38,34.17,30.3,38.0,BRGY. TINAJEROS
1173,0603A,198,86,112,182,79,103,91.92,91.86,91.96,BRGY. TINAJEROS
1174,0604A,199,88,111,183,83,100,91.96,94.32,90.09,BRGY. TINAJEROS
1175,0605A,199,103,96,181,92,89,90.95,89.32,92.71,BRGY. TINAJEROS
1176,0606A,145,68,77,98,44,54,67.59,64.71,70.13,BRGY. TINAJEROS
1177,0607A,145,70,75,93,52,41,64.14,74.29,54.67,BRGY. TINAJEROS
1178,0607B,197,104,93,130,66,64,65.99,63.46,68.82,BRGY. TINAJEROS
1179,0608A,200,104,96,113,56,57,56.5,53.85,59.38,BRGY. TINAJEROS
1180,0609A,189,103,86,144,75,69,76.19,72.82,80.23,BRGY. TINAJEROS
1181,0610A,189,86,103,101,48,53,53.44,55.81,51.46,BRGY. TINAJEROS
1182,0611A,197,99,98,182,93,89,92.39,93.94,90.82,BRGY. TINAJEROS
1183,0612A,199,81,118,167,67,100,83.92,82.72,84.75,BRGY. TINAJEROS
1184,0613A,193,93,100,159,78,81,82.38,83.87,81.0,BRGY. TINAJEROS
1185,0614A,182,80,102,164,72,92,90.11,90.0,90.2,BRGY. TINAJEROS
1186,0615A,164,72,92,139,59,80,84.76,81.94,86.96,BRGY. TINAJEROS
1187,0616A,140,63,77,96,42,54,68.57,66.67,70.13,BRGY. TINAJEROS
1188,0617A,197,96,101,103,48,55,52.28,50.0,54.46,BRGY. TINAJEROS
1189,0618A,195,101,94,66,32,34,33.85,31.68,36.17,BRGY. TINAJEROS
1190,0619A,185,89,96,64,30,34,34.59,33.71,35.42,BRGY. TINAJEROS
1191,0620A,192,95,97,104,44,60,54.17,46.32,61.86,BRGY. TINAJEROS
1192,0621A,192,85,107,72,35,37,37.5,41.18,34.58,BRGY. TINAJEROS
1193,0622A,163,80,83,68,34,34,41.72,42.5,40.96,BRGY. TINAJEROS
1194,0622B,140,83,57,12,5,7,8.57,6.02,12.28,BRGY. TINAJEROS
1195,0623A,196,98,98,81,41,40,41.33,41.84,40.82,BRGY. TINAJEROS
1196,0623B,76,33,43,6,2,4,7.89,6.06,9.3,BRGY. TINAJEROS
1197,0624A,142,68,74,104,53,51,73.24,77.94,68.92,BRGY. TINAJEROS
1198,0624B,196,97,99,18,11,7,9.18,11.34,7.07,BRGY. TINAJEROS
1199,0376A,192,91,101,136,65,71,70.83,71.43,70.3,BRGY. TONSUYA
1200,0376B,190,79,111,120,50,70,63.16,63.29,63.06,BRGY. TONSUYA
1201,0376C,200,93,107,71,37,34,35.5,39.78,31.78,BRGY. TONSUYA
1202,0377A,197,93,104,125,60,65,63.45,64.52,62.5,BRGY. TONSUYA
1203,0377B,199,102,97,117,56,61,58.79,54.9,62.89,BRGY. TONSUYA
1204,0377C,200,92,108,128,56,72,64.0,60.87,66.67,BRGY. TONSUYA
1205,0378A,181,89,92,145,70,75,80.11,78.65,81.52,BRGY. TONSUYA
1206,0378B,176,92,84,132,64,68,75.0,69.57,80.95,BRGY. TONSUYA
1207,0378C,194,92,102,130,63,67,67.01,68.48,65.69,BRGY. TONSUYA
1208,0378D,172,90,82,116,62,54,67.44,68.89,65.85,BRGY. TONSUYA
1209,0378E,169,90,79,114,62,52,67.46,68.89,65.82,BRGY. TONSUYA
1210,0378F,197,98,99,10,4,6,5.08,4.08,6.06,BRGY. TONSUYA
1211,0379A,192,87,105,177,80,97,92.19,91.95,92.38,BRGY. TONSUYA
1212,0379B,193,94,99,166,80,86,86.01,85.11,86.87,BRGY. TONSUYA
1213,0379C,194,91,103,156,77,79,80.41,84.62,76.7,BRGY. TONSUYA
1214,0379D,188,83,105,153,67,86,81.38,80.72,81.9,BRGY. TONSUYA
1215,0379E,185,94,91,138,73,65,74.59,77.66,71.43,BRGY. TONSUYA
1216,0379F,197,85,112,166,73,93,84.26,85.88,83.04,BRGY. TONSUYA
1217,0379G,192,87,105,151,67,84,78.65,77.01,80.0,BRGY. TONSUYA
1218,0380A,200,88,112,160,67,93,80.0,76.14,83.04,BRGY. TONSUYA
1219,0380B,193,103,90,131,72,59,67.88,69.9,65.56,BRGY. TONSUYA
1220,0380C,195,89,106,135,63,72,69.23,70.79,67.92,BRGY. TONSUYA
1221,0380D,195,92,103,0,0,0,0.0,0.0,0.0,BRGY. TONSUYA
1222,0381A,192,84,108,147,68,79,76.56,80.95,73.15,BRGY. TONSUYA
1223,0381B,182,82,100,119,57,62,65.38,69.51,62.0,BRGY. TONSUYA
1224,0381C,183,87,96,110,52,58,60.11,59.77,60.42,BRGY. TONSUYA
1225,0382A,194,100,94,115,50,65,59.28,50.0,69.15,BRGY. TONSUYA
1226,0382B,195,98,97,1,1,0,0.51,1.02,0.0,BRGY. TONSUYA
1227,0383A,200,96,104,137,71,66,68.5,73.96,63.46,BRGY. TONSUYA
1228,0383B,172,79,93,9,3,6,5.23,3.8,6.45,BRGY. TONSUYA
1229,0384A,185,97,87,155,83,71,83.78,85.57,81.61,BRGY. TONSUYA
1230,0384B,189,85,104,4,0,4,2.12,0.0,3.85,BRGY. TONSUYA
1231,0384C,198,109,89,6,4,2,3.03,3.67,2.25,BRGY. TONSUYA
1232,0384D,197,107,90,5,4,1,2.54,3.74,1.11,BRGY. TONSUYA
1233,0385A,180,81,99,153,67,86,85.0,82.72,86.87,BRGY. TONSUYA
1234,0385B,172,82,90,114,55,59,66.28,67.07,65.56,BRGY. TONSUYA
1235,0386A,165,73,92,122,57,65,73.94,78.08,70.65,BRGY. TONSUYA
1236,0387A,176,73,103,151,65,86,85.8,89.04,83.5,BRGY. TONSUYA
1237,0388A,194,89,105,156,69,87,80.41,77.53,82.86,BRGY. TONSUYA
1238,0388B,196,91,105,8,1,7,4.08,1.1,6.67,BRGY. TONSUYA
1239,0388C,194,101,93,3,0,3,1.55,0.0,3.23,BRGY. TONSUYA
1240,0389A,175,71,104,143,59,84,81.71,83.1,80.77,BRGY. TONSUYA
1241,0389B,188,86,102,1,0,1,0.53,0.0,0.98,BRGY. TONSUYA
1242,0390A,193,83,110,151,66,85,78.24,79.52,77.27,BRGY. TONSUYA
1243,0390B,179,89,90,146,72,74,81.56,80.9,82.22,BRGY. TONSUYA
1244,0391A,194,99,95,156,79,77,80.41,79.8,81.05,BRGY. TONSUYA
1245,0392A,188,96,92,144,77,67,76.6,80.21,72.83,BRGY. TONSUYA
1246,0393A,187,70,117,158,60,98,84.49,85.71,83.76,BRGY. TONSUYA
1247,0394A,187,81,106,152,66,86,81.28,81.48,81.13,BRGY. TONSUYA
1248,0394B,189,104,85,144,82,62,76.19,78.85,72.94,BRGY. TONSUYA
1249,0394C,178,92,86,141,74,67,79.21,80.43,77.91,BRGY. TONSUYA
1250,0395A,188,87,101,161,74,87,85.64,85.06,86.14,BRGY. TONSUYA
1251,0395B,186,89,97,144,69,75,77.42,77.53,77.32,BRGY. TONSUYA
1252,0395C,197,88,109,137,60,77,69.54,68.18,70.64,BRGY. TONSUYA
1253,0395D,188,75,113,161,63,98,85.64,84.0,86.73,BRGY. TONSUYA
1254,0396A,193,96,97,148,72,76,76.68,75.0,78.35,BRGY. TONSUYA
1255,0396B,189,87,102,157,72,85,83.07,82.76,83.33,BRGY. TONSUYA
1256,0396C,175,83,92,137,68,69,78.29,81.93,75.0,BRGY. TONSUYA
1257,0396D,180,84,96,146,64,82,81.11,76.19,85.42,BRGY. TONSUYA
1258,0397A,175,92,83,141,70,71,80.57,76.09,85.54,BRGY. TONSUYA
1259,0397B,185,86,99,120,58,62,64.86,67.44,62.63,BRGY. TONSUYA
1260,0397C,193,89,104,156,72,84,80.83,80.9,80.77,BRGY. TONSUYA
1261,0397D,192,88,104,187,87,100,97.4,98.86,96.15,BRGY. TONSUYA
1262,0397E,198,95,103,176,86,90,88.89,90.53,87.38,BRGY. TONSUYA
1263,0397F,189,98,91,175,91,84,92.59,92.86,92.31,BRGY. TONSUYA
1264,0398A,194,99,95,178,89,89,91.75,89.9,93.68,BRGY. TONSUYA
1265,0398B,197,94,103,181,90,91,91.88,95.74,88.35,BRGY. TONSUYA
1266,0398C,189,99,90,173,92,81,91.53,92.93,90.0,BRGY. TONSUYA
1267,0398D,188,98,90,178,93,85,94.68,94.9,94.44,BRGY. TONSUYA
1268,0399A,184,84,100,161,78,83,87.5,92.86,83.0,BRGY. TONSUYA
1269,0399B,194,86,108,171,74,97,88.14,86.05,89.81,BRGY. TONSUYA
1270,0399C,192,95,97,159,81,78,82.81,85.26,80.41,BRGY. TONSUYA
1271,0399D,177,91,86,150,81,69,84.75,89.01,80.23,BRGY. TONSUYA
1272,0399E,189,88,101,5,1,4,2.65,1.14,3.96,BRGY. TONSUYA
1273,0399F,195,84,111,4,1,3,2.05,1.19,2.7,BRGY. TONSUYA
1274,0399G,188,87,101,1,1,0,0.53,1.15,0.0,BRGY. TONSUYA
1275,0400A,197,92,105,187,84,103,94.92,91.3,98.1,BRGY. TONSUYA
1276,0400B,188,90,98,172,84,88,91.49,93.33,89.8,BRGY. TONSUYA
1277,0400C,187,92,95,153,79,74,81.82,85.87,77.89,BRGY. TONSUYA
1278,0400D,192,97,95,170,86,84,88.54,88.66,88.42,BRGY. TONSUYA
1279,0401A,192,91,101,183,87,96,95.31,95.6,95.05,BRGY. TONSUYA
1280,0401B,192,82,110,173,72,101,90.1,87.8,91.82,BRGY. TONSUYA
1281,0401C,194,90,104,171,78,93,88.14,86.67,89.42,BRGY. TONSUYA
1282,0401D,188,94,94,109,55,54,57.98,58.51,57.45,BRGY. TONSUYA
1283,0402A,197,80,117,172,69,103,87.31,86.25,88.03,BRGY. TONSUYA
1284,0402B,189,71,118,179,68,111,94.71,95.77,94.07,BRGY. TONSUYA
1285,0402C,185,87,98,176,82,94,95.14,94.25,95.92,BRGY. TONSUYA
1286,0402D,196,105,91,6,2,4,3.06,1.9,4.4,BRGY. TONSUYA
1287,0403A,195,97,98,171,85,86,87.69,87.63,87.76,BRGY. TONSUYA
1288,0403B,200,83,117,184,77,107,92.0,92.77,91.45,BRGY. TONSUYA
1289,0403C,198,98,100,0,0,0,0.0,0.0,0.0,BRGY. TONSUYA
1290,0403D,167,85,82,1,1,0,0.6,1.18,0.0,BRGY. TONSUYA
1291,0404A,197,80,117,186,75,111,94.42,93.75,94.87,BRGY. TONSUYA
1292,0404B,192,88,104,177,80,97,92.19,90.91,93.27,BRGY. TONSUYA
1293,0404C,188,104,84,159,90,69,84.57,86.54,82.14,BRGY. TONSUYA
1294,0404D,186,79,107,157,73,84,84.41,92.41,78.5,BRGY. TONSUYA
1295,0405A,195,77,118,165,68,97,84.62,88.31,82.2,BRGY. TONSUYA
1296,0405B,193,98,95,154,76,78,79.79,77.55,82.11,BRGY. TONSUYA
1297,0405C,194,91,103,156,68,88,80.41,74.73,85.44,BRGY. TONSUYA
1298,0405D,190,87,103,155,71,84,81.58,81.61,81.55,BRGY. TONSUYA
1299,0406A,194,79,115,173,72,101,89.18,91.14,87.83,BRGY. TONSUYA
1300,0406B,195,87,108,189,84,105,96.92,96.55,97.22,BRGY. TONSUYA
1301,0406C,186,95,91,177,90,87,95.16,94.74,95.6,BRGY. TONSUYA
1302,0406D,192,89,103,184,86,98,95.83,96.63,95.15,BRGY. TONSUYA
1303,0406E,191,73,118,181,69,112,94.76,94.52,94.92,BRGY. TONSUYA
1304,0406F,197,112,85,2,2,0,1.02,1.79,0.0,BRGY. TONSUYA
1305,0407A,195,91,104,188,85,103,96.41,93.41,99.04,BRGY. TONSUYA
1306,0407B,191,94,97,180,88,92,94.24,93.62,94.85,BRGY. TONSUYA
1307,0407C,184,84,100,169,77,92,91.85,91.67,92.0,BRGY. TONSUYA
1308,0407D,184,92,92,172,85,87,93.48,92.39,94.57,BRGY. TONSUYA
1309,0408A,193,88,105,177,80,97,91.71,90.91,92.38,BRGY. TONSUYA
1310,0408B,188,79,109,166,68,98,88.3,86.08,89.91,BRGY. TONSUYA
1311,0408C,192,73,119,179,68,111,93.23,93.15,93.28,BRGY. TONSUYA
1312,0408D,197,92,105,172,77,95,87.31,83.7,90.48,BRGY. TONSUYA
1313,0408E,200,95,105,5,1,4,2.5,1.05,3.81,BRGY. TONSUYA
1314,0409A,192,85,107,164,70,94,85.42,82.35,87.85,BRGY. TONSUYA
1315,0409B,194,102,92,7,4,3,3.61,3.92,3.26,BRGY. TONSUYA
1316,0410A,200,86,114,183,78,105,91.5,90.7,92.11,BRGY. TONSUYA
1317,0410B,191,78,113,148,62,86,77.49,79.49,76.11,BRGY. TONSUYA
1318,0410C,189,93,96,1,0,1,0.53,0.0,1.04,BRGY. TONSUYA
1319,0410D,188,83,105,5,2,3,2.66,2.41,2.86,BRGY. TONSUYA
1320,0410E,191,81,110,2,2,0,1.05,2.47,0.0,BRGY. TONSUYA
1321,0410F,182,85,97,3,1,2,1.65,1.18,2.06,BRGY. TONSUYA
1322,0410G,162,84,78,2,2,0,1.23,2.38,0.0,BRGY. TONSUYA
1323,0411A,196,85,111,159,77,82,81.12,90.59,73.87,BRGY. TONSUYA
1324,0411B,193,93,100,176,83,93,91.19,89.25,93.0,BRGY. TONSUYA
1325,0411C,191,88,103,6,2,4,3.14,2.27,3.88,BRGY. TONSUYA
1326,0412A,199,92,107,161,77,84,80.9,83.7,78.5,BRGY. TONSUYA
1327,0412B,190,80,110,162,68,94,85.26,85.0,85.45,BRGY. TONSUYA
1328,0412C,193,79,114,190,78,112,98.45,98.73,98.25,BRGY. TONSUYA
1329,0413A,194,90,104,180,83,97,92.78,92.22,93.27,BRGY. TONSUYA
1330,0413B,188,80,108,153,65,88,81.38,81.25,81.48,BRGY. TONSUYA
1331,0413C,155,82,73,4,2,2,2.58,2.44,2.74,BRGY. TONSUYA
1332,0414A,194,98,96,162,81,81,83.51,82.65,84.38,BRGY. TONSUYA
1333,0414B,193,100,93,149,77,72,77.2,77.0,77.42,BRGY. TONSUYA
1334,0414C,198,89,109,3,1,2,1.52,1.12,1.83,BRGY. TONSUYA
1335,0414D,146,77,69,1,1,0,0.68,1.3,0.0,BRGY. TONSUYA
1336,0415A,196,75,121,192,73,119,97.96,97.33,98.35,BRGY. TONSUYA
1337,0415B,196,90,106,184,84,100,93.88,93.33,94.34,BRGY. TONSUYA
1338,0415C,194,103,91,7,4,3,3.61,3.88,3.3,BRGY. TONSUYA
1339,0416A,198,95,103,193,93,100,97.47,97.89,97.09,BRGY. TONSUYA
1340,0416B,194,94,100,188,91,97,96.91,96.81,97.0,BRGY. TONSUYA
1341,0417A,197,90,107,190,87,103,96.45,96.67,96.26,BRGY. TONSUYA
1342,0417B,197,79,118,188,78,110,95.43,98.73,93.22,BRGY. TONSUYA
1343,0417C,196,96,100,185,92,93,94.39,95.83,93.0,BRGY. TONSUYA
1344,0417D,193,91,102,187,89,98,96.89,97.8,96.08,BRGY. TONSUYA
1345,0489A,187,81,106,129,56,73,68.98,69.14,68.87,BRGY. TUGATOG
1346,0490A,194,88,106,130,57,73,67.01,64.77,68.87,BRGY. TUGATOG
1347,0491A,196,95,101,122,55,67,62.24,57.89,66.34,BRGY. TUGATOG
1348,0492A,197,98,99,104,52,52,52.79,53.06,52.53,BRGY. TUGATOG
1349,0493A,198,82,116,120,46,74,60.61,56.1,63.79,BRGY. TUGATOG
1350,0494A,196,97,99,106,50,56,54.08,51.55,56.57,BRGY. TUGATOG
1351,0495A,200,90,110,123,50,73,61.5,55.56,66.36,BRGY. TUGATOG
1352,0496A,196,96,100,142,72,70,72.45,75.0,70.0,BRGY. TUGATOG
1353,0497A,198,83,115,133,56,77,67.17,67.47,66.96,BRGY. TUGATOG
1354,0498A,171,84,87,117,59,58,68.42,70.24,66.67,BRGY. TUGATOG
1355,0499A,174,72,102,112,42,70,64.37,58.33,68.63,BRGY. TUGATOG
1356,0500A,200,99,101,156,78,78,78.0,78.79,77.23,BRGY. TUGATOG
1357,0500B,200,106,94,156,80,76,78.0,75.47,80.85,BRGY. TUGATOG
1358,0500C,199,108,91,154,82,72,77.39,75.93,79.12,BRGY. TUGATOG
1359,0501A,191,90,101,149,67,82,78.01,74.44,81.19,BRGY. TUGATOG
1360,0502A,181,75,106,142,61,81,78.45,81.33,76.42,BRGY. TUGATOG
1361,0502B,183,79,104,155,65,90,84.7,82.28,86.54,BRGY. TUGATOG
1362,0503A,187,95,92,153,76,77,81.82,80.0,83.7,BRGY. TUGATOG
1363,0504A,187,76,111,152,53,99,81.28,69.74,89.19,BRGY. TUGATOG
1364,0504B,189,81,108,152,62,90,80.42,76.54,83.33,BRGY. TUGATOG
1365,0504C,195,93,102,135,64,71,69.23,68.82,69.61,BRGY. TUGATOG
1366,0505A,192,81,111,170,72,98,88.54,88.89,88.29,BRGY. TUGATOG
1367,0505B,190,86,104,165,71,94,86.84,82.56,90.38,BRGY. TUGATOG
1368,0505C,191,82,109,166,73,93,86.91,89.02,85.32,BRGY. TUGATOG
1369,0506A,199,105,94,165,84,81,82.91,80.0,86.17,BRGY. TUGATOG
1370,0506B,194,95,99,171,77,94,88.14,81.05,94.95,BRGY. TUGATOG
1371,0506C,195,90,105,128,55,73,65.64,61.11,69.52,BRGY. TUGATOG
1372,0507A,197,103,94,120,65,55,60.91,63.11,58.51,BRGY. TUGATOG
1373,0507B,192,82,110,159,69,90,82.81,84.15,81.82,BRGY. TUGATOG
1374,0508A,194,104,90,173,94,79,89.18,90.38,87.78,BRGY. TUGATOG
1375,0508B,197,107,90,1,0,1,0.51,0.0,1.11,BRGY. TUGATOG
1376,0509A,193,81,112,171,69,102,88.6,85.19,91.07,BRGY. TUGATOG
1377,0509B,174,82,92,1,0,1,0.57,0.0,1.09,BRGY. TUGATOG
1378,0510A,197,98,99,150,77,73,76.14,78.57,73.74,BRGY. TUGATOG
1379,0511A,197,105,92,139,77,62,70.56,73.33,67.39,BRGY. TUGATOG
1380,0511B,184,87,97,119,58,61,64.67,66.67,62.89,BRGY. TUGATOG
1381,0511C,190,94,96,159,76,83,83.68,80.85,86.46,BRGY. TUGATOG
1382,0512A,199,90,109,123,56,67,61.81,62.22,61.47,BRGY. TUGATOG
1383,0513A,197,97,100,85,44,41,43.15,45.36,41.0,BRGY. TUGATOG
1384,0514A,194,96,98,91,45,46,46.91,46.88,46.94,BRGY. TUGATOG
1385,0515A,197,86,111,139,58,81,70.56,67.44,72.97,BRGY. TUGATOG
1386,0516A,199,91,108,95,46,49,47.74,50.55,45.37,BRGY. TUGATOG
1387,0517A,196,84,112,105,47,58,53.57,55.95,51.79,BRGY. TUGATOG
1388,0518A,197,88,109,132,61,71,67.01,69.32,65.14,BRGY. TUGATOG
1389,0519A,198,101,97,140,72,68,70.71,71.29,70.1,BRGY. TUGATOG
1390,0520A,200,80,120,153,60,93,76.5,75.0,77.5,BRGY. TUGATOG
1391,0520B,147,69,78,5,3,2,3.4,4.35,2.56,BRGY. TUGATOG
1392,0521A,183,79,104,118,52,66,64.48,65.82,63.46,BRGY. TUGATOG
1393,0521B,143,65,78,75,39,36,52.45,60.0,46.15,BRGY. TUGATOG
1394,0522A,176,76,100,137,64,73,77.84,84.21,73.0,BRGY. TUGATOG
1395,0523A,176,77,99,152,64,88,86.36,83.12,88.89,BRGY. TUGATOG
1396,0524A,162,67,95,145,59,86,89.51,88.06,90.53,BRGY. TUGATOG
1397,0524B,166,82,84,119,61,58,71.69,74.39,69.05,BRGY. TUGATOG
1398,0525A,146,57,89,108,43,65,73.97,75.44,73.03,BRGY. TUGATOG
1399,0526A,147,62,85,118,44,74,80.27,70.97,87.06,BRGY. TUGATOG
1400,0526B,151,64,87,89,38,51,58.94,59.38,58.62,BRGY. TUGATOG
1401,0527A,177,94,83,131,72,59,74.01,76.6,71.08,BRGY. TUGATOG
1402,0528A,152,69,83,114,47,67,75.0,68.12,80.72,BRGY. TUGATOG
1403,0529A,142,73,69,112,57,55,78.87,78.08,79.71,BRGY. TUGATOG
1404,0530A,126,50,76,103,38,65,81.75,76.0,85.53,BRGY. TUGATOG
1405,0530B,127,56,71,45,20,25,35.43,35.71,35.21,BRGY. TUGATOG
1406,0531A,156,62,94,124,49,75,79.49,79.03,79.79,BRGY. TUGATOG
1407,0532A,151,81,70,104,47,57,68.87,58.02,81.43,BRGY. TUGATOG
1408,0533A,140,59,81,118,54,64,84.29,91.53,79.01,BRGY. TUGATOG
1409,0533B,138,58,80,99,38,61,71.74,65.52,76.25,BRGY. TUGATOG
1410,0534A,161,71,90,112,50,62,69.57,70.42,68.89,BRGY. TUGATOG
1411,0535A,119,53,66,99,44,55,83.19,83.02,83.33,BRGY. TUGATOG
1412,0535B,138,61,77,66,27,39,47.83,44.26,50.65,BRGY. TUGATOG
1413,0536A,178,89,89,146,70,76,82.02,78.65,85.39,BRGY. TUGATOG
1414,0537A,155,69,86,126,57,69,81.29,82.61,80.23,BRGY. TUGATOG
1415,0538A,164,82,82,132,65,67,80.49,79.27,81.71,BRGY. TUGATOG
1416,0539A,152,67,85,139,62,77,91.45,92.54,90.59,BRGY. TUGATOG
1417,0540A,158,74,84,106,53,53,67.09,71.62,63.1,BRGY. TUGATOG
1418,0540B,123,55,68,108,48,60,87.8,87.27,88.24,BRGY. TUGATOG
1419,0541A,156,68,88,121,55,66,77.56,80.88,75.0,BRGY. TUGATOG
1420,0541B,134,54,80,89,39,50,66.42,72.22,62.5,BRGY. TUGATOG
1421,0542A,129,59,70,97,45,52,75.19,76.27,74.29,BRGY. TUGATOG
1422,0543A,168,81,87,147,71,76,87.5,87.65,87.36,BRGY. TUGATOG
1423,0544A,193,93,100,99,42,57,51.3,45.16,57.0,BRGY. TUGATOG
1424,0544B,134,70,64,2,2,0,1.49,2.86,0.0,BRGY. TUGATOG
1425,0545A,159,79,80,91,46,45,57.23,58.23,56.25,BRGY. TUGATOG
1426,0546A,177,89,88,61,30,31,34.46,33.71,35.23,BRGY. TUGATOG
1427,0547A,170,86,84,87,45,42,51.18,52.33,50.0,BRGY. TUGATOG
1428,0548A,196,108,88,155,87,68,79.08,80.56,77.27,BRGY. TUGATOG
